1929 ou 1989 ?	1929年还是1989年?
PARIS – Alors que la crise économique s'étend et s'aggrave, le monde cherche des analogies historiques pour essayer de comprendre ce qui se passe.	巴黎-随着经济危机不断加深和蔓延，整个世界一直在寻找历史上的类似事件希望有助于我们了解目前正在发生的情况。
Au début de la crise, beaucoup de gens faisaient le rapprochement avec 1982 ou 1973, ce qui était rassurant, car ces deux dates correspondent à des ralentissements économiques cycliques classiques.	一开始，很多人把这次危机比作1982年或1973年所发生的情况，这样得类比是令人宽心的，因为这两段时期意味着典型的周期性衰退。
Aujourd'hui le climat est bien plus lourd, et l'on évoque de plus en plus 1929 et 1931, même si certains pays continuent à se comporter comme s'il s'agissait d'une crise classique et non d'un événement exceptionnel.	如今人们的心情却是沉重多了，许多人开始把这次危机与1929年和1931年相比，即使一些国家政府的表现仍然似乎把视目前的情况为是典型的而看见的衰退。
La tendance est soit à un excès de modération soit à un effort qui s'exerce dans plusieurs directions à la fois.	目前的趋势是，要么是过度的克制（欧洲 ） ， 要么是努力的扩展（美国 ） 。
L'Europe se montre précautionneuse au nom de la défense de l'euro et de la lutte contre la dette, tandis que les USA agissent sur plusieurs fronts pour ne pas gaspiller une occasion idéale de mettre en œuvre des réformes structurelles indispensables.	欧洲在避免债务和捍卫欧元的名义下正变得谨慎，而美国已经在许多方面行动起来，以利用这一理想的时机来实行急需的结构性改革。
Pour les géostratégistes, tant du point de vue politique qu'économique, c'est 1989 qui vient spontanément à l'esprit.	然而，作为地域战略学家，无论是从政治意义还是从经济意义上，让我自然想到的年份是1989年。
Certes, la chute de Lehman Brothers n'a rien à voir avec la chute du mur de Berlin.	当然，雷曼兄弟公司的倒闭和柏林墙的倒塌没有任何关系。
Au premier abord, on peut y voir une antithèse : d'un coté la fin d'un mur qui symbolisait l'oppression et des divisions artificielles et de l'autre l'écroulement d'une institution apparemment indestructible et rassurante du capitalisme financier.	事实上，从表面上看，两者似乎是完全是相反的：一个是象征着压抑和人为分裂的柏林墙的倒塌，而另一个是看似坚不可摧的并令人安心的金融资本主义机构的倒塌。
Pourtant, 2008-2009 comme 1989 pourrait bien correspondre à un changement d'époque dont les conséquences vont se faire sentir durant des décennies.	然而，和1989年一样，2008-2009年很可能也能被视为一个划时代的改变，其带来的发人深省的后果将在几十年后仍能让我们感受得到。
La fin du clivage idéologique Est/Ouest et la fin de la confiance absolue dans l'économie libérale constituent des tournants historiques.	东西方意识形态鸿沟的结束，以及对市场绝对信心的后果，都是历史的转折点。
Les événements de 2009 pourraient menacer les résultats positifs de 1989, notamment la réunification pacifique de l'Europe et le triomphe des principes démocratiques sur les tendances nationalistes, voire xénophobes.	而2009年所发生的事情可能会威胁1989年革命所带来的积极成果，包括欧洲的和平统一和民主制度战胜了民族主义倾向，如果不是恐外倾向的话。
En 1989, la démocratie libérale l'a emporté sur l'idéologie socialiste incarnée et défendue par le bloc soviétique.	1989年，自由民主战胜了由苏联集团具体化并推崇的社会主义意识形态。
Pour nombre de ses partisans, c'est le président Reagan avec son escalade délibérée dans la course aux armements qui a poussé l'économie soviétique au bord du précipice, faisant ainsi la preuve de la supériorité des sociétés libérales et de l'économie de marché.	对于里根总统的许多的支持者来说，就是他精心策划的军备竞赛的升级，把苏联经济推向了崩溃的边缘，从而充分显示了自由社会和自由市场的优越性。
Les différences sont évidentes entre 1999 et aujourd'hui.	当然，现在的情况和1989年的情况明显不同了。
Avant tout, les révolutions de 1989 et l'effondrement de l'Union soviétique auquel elles ont abouti ont mis fin à une bipolarité globale, alors que 2009 va sans doute déboucher sur une nouvelle forme de bipolarité, avec la Chine à la place de l'Union soviétique.	首先，也许是最重要的，1989年的革命和随后的苏联解体结束了全球的两极化。 与此相反，2009年很可能会为一种新的两极化形式铺平道路，只是中国取代了苏联。
D'autre part, si en 1989 la démocratie et l'économie de marché sont apparus clairement comme les gagnants (plus fragiles qu'escomptés) en 2009 - avec une crise qui s'étend à toute la planète - il est difficile de distinguer entre gagnants et perdants.	其二，民主制度和市场资本主义，或许要比预期的要脆弱些，看来确实是当时的赢家。
Tout le monde semble perdant, même si certains sont plus touchés que d'autres.	而在2009年，随着全球危机的蔓延，却很难区分赢家和输家；每个人似乎都是输家，即使有些国家比其它国家受到的影响更大。
Mais l'Histoire est injuste et les USA, même s'ils portent une responsabilité majeure dans la crise d'aujourd'hui, pourraient s'en tirer bien mieux que la plupart des autres pays.	而历史是不公平的。 尽管美国要为当今的全球危机负更大的责任，但美国可能会比大多数国家以更良好的势态走出困境。
Ils ne seront pas les seuls.	美国会恢复得更好，但并不是唯一能恢复的国家。
En tant que professeur invité à Harvard et au MIT, j'ai un bon aperçu de ce à quoi pourrait ressembler le monde quand la crise sera passée.	作为哈佛大学和麻省理工学院的访问教授，我能看到危机过后的世界是什么样子的。
On perçoit l'émergence d'un monde dominé par l'Amérique et l'Asie.	我们能感受到一个美国和亚洲占主导地位的世界正在形成。
De l'incroyable laboratoire des médias du MIT aux départements de mathématiques et d'économie de Harvard, les Asiatiques (notamment des Chinois et des Indiens) sont partout, comme les Romains à Athènes un siècle avant Jésus-Christ : plein d'admiration pour ceux dont ils apprennent énormément et qu'ils dépasseront lors des prochaines décennies.	从一流的麻省理工学院的媒体实验室到哈佛大学的数学和经济系，亚洲人-尤其是中国和印度人-到处都是，犹如公元前一世纪在雅典的罗马人一样：他们对那里学到太多东西的人们充满了敬佩，而他们将在今后几十年打败他们学习的对象。
Mais avant que n'émerge un nouvel ordre mondial, la planète risque d'être confrontée à une vague de désordre, ou peut-être même de véritable chaos.	但是，在这一新秩序的出现之前，世界可能会面临更广泛的混沌，如果不是彻底的混乱的话。
Que va-t-il arriver par exemple pour un pays aussi central et vulnérable que l'Egypte quand les centaines de milliers d'Egyptiens qui travaillent dans le Golfe devront rentrer chez eux à cause de la crise dans les pays producteurs de pétrole ?	例如，对埃及这样一个重要而又脆弱的国家，有数十万的埃及人曾在海湾工作但现在因石油生产国出现的危机而被迫返回了自己的家园，那埃及会发生什么情况呢？
Quand les riches deviennent moins riches, les pauvres deviennent encore plus pauvres.	当富人不再那么富了，穷人就会更穷。
Et que va-t-il se passer pour les travailleurs étrangers qui ont réalisé leur ampquot;rêve européenampquot; et risquent de se trouver confrontés à une explosion de xénophobie dans les pays d'une Europe supposée ouverte.	还有，对于那些追求“欧洲梦”的外来工人，现在他们面临着理应是开放的欧洲国家的仇外心态可能的爆发，他们会有怎样的遭遇？
Finalement, les conséquences de 1989 ont été moins durables que ce que beaucoup d'observateurs (moi y compris) le pensaient.	1989年革命所带来的成果，最后没有包括我在内许多观察家所想象的那么持久。
Il reste à espérer que de même, les effets de 2009 seront moins dramatiques que ce que l'on peut l'imaginer pour l'instant - guidés par l'intuition et par un réflexe historique.	我们只能希望2009年的危机同样地最后被证明是远远低于我们现在以直觉和历史回顾的方式��感觉到的那么剧烈。
	
Un siècle d’incompétence	百年愚顽
BERLIN – La crise financière et économique survenue en 2008 a constitué la plus grande mise à l’épreuve économique depuis la Grande Dépression, ainsi que le plus important défi auquel ont été confrontés le système social et le système politique depuis la Seconde Guerre mondiale.	柏林 — — 2008年爆发的全球金融和经济危机是自大萧条以来最严峻的一次经济压力测试，也是自二战以来社会和政治制度所面临的最严重挑战。
Elle a non seulement mis en péril les marchés financiers et les monnaies, mais également exposé un certain nombre de défaillances réglementaires et de gouvernance, qui ne sont encore aujourd’hui pas entièrement résolues.	它不仅对金融市场和货币构成威胁；而且还暴露了迄今为止都无法完全解决的严重的监管和治理缺陷。
En effet, la crise de 2008 laissera certainement derrière elle le souvenir d’un moment charnière, mais pas parce qu’elle aura conduit à des réformes permettant de renforcer la résilience économiques et de mettre un terme aux vulnérabilités.	事实上，2008年危机极有可能被视为一座分水岭，但却并非因为它导致了强化经济弹性和消除经济弱点的改革而永久留在人们的记忆当中。
Au contraire, l’incapacité des dirigeants à tirer les leçons de la Grande Récession, et à agir en conséquence, risque d’ouvrir la voie à une série de nouvelles crises, économiques ou autres, au cours des prochaines décennies.	相反，领导人未能汲取大萧条的教训，更不用说为此采取相应的预防对策可能引发未来几十年一系列新的经济和其他危机。
Quel que soit le degré de gravité des crises qui nous attendent, les historiens du siècle prochain observeront sans doute avec désolation notre manque de vision à long terme.	无论这些危机有多严重，一个世纪后的历史学家都极有可能绝望于我们的短视。
Ils raconteront comment les analystes et régulateurs se sont étroitement concentrés sur la réparation du système financier en renforçant les programmes nationaux de courte vue.	他们将会看到，分析人士和监管机构通过强化国家监管机制，仅仅是狭隘地专注于修复金融体系。
Les historiens y verront certes une démarche compréhensible, mais certainement pas constitutive de l’unique impératif.	尽管这一目标并非全无价值，但就像历史学家们所指出的那样，这绝不是唯一一件必须要做的事。
Pour préparer le monde à affronter les défis engendrés par la mondialisation et le développement technologique, dans une démarche de durabilité et de croissance équitable, les institutions de gouvernance et les réglementations au niveau national et international devront être radicalement améliorées.	为使世界能够以确保可持续及平衡增长的方式来应对全球化和技术进步所带来的挑战，就必须对国内和国际两级治理机构和制度进行大规模升级。
Or, les efforts investis à cet égard se révèlent bien insuffisants.	但目前这方面的投入还远远不够。
Au-delà d’organes régionaux tels que l’Union européenne, la gouvernance financière internationale demeure largement inchangée.	除欧盟等地区机构外，国际金融治理机构基本仍未受到波及。
Pire encore, dans la mesure où les correctifs partiels apportés au système financier permettront encore davantage de mondialisation, ils finiront par aggraver la situation, à mesure qu’augmentera la pression sur une gouvernance et des cadres réglementaires déjà inadéquats, pas seulement dans le domaine de la finance, mais également en matière économique et technologique.	更糟的是，因为部分修复金融体系将会带来进一步全球化，这些举措最终会恶化现有问题，因为此举不仅在金融、而且在其他经济和技术领域增加了对本已欠缺的治理和监管框架的压力。
Dans le même temps, il faut s’attendre à ce que les investissements colossaux consacrés à la sécurisation de taux de rendement supérieurs alimentent l’innovation technologique, éprouvant encore davantage les systèmes réglementaires dans le domaine de la finance et au-delà.	此外，专注于提高回报率的巨额金融投资很有可能会推动技术创新，并由此进一步加大对金融和其他监管体系所造成的压力。
Les avancées technologiques majeures appuyées par l’argent bon marché peuvent conduire les marchés à évoluer si rapidement que le changement politique et institutionnel ne peut suivre le rythme.	廉价资金推动的重大技术创新可以令市场变化速度快到政策和机构变化均无法适应。
De nouveaux marchés peuvent par ailleurs émerger, et conférer des gains considérables aux adopteurs et investisseurs précoces, qui bénéficient de leurs quelques pas d’avance restante par rapport aux régulateurs nationaux et internationaux.	同时新市场的出现可以为早期进入者或投资者带来巨大的回报，并使他们可以持续受益于相对国内及国际监管机构的领先。
C’est ce qu’il s’est produit à l’approche de la crise de 2008.	这恰恰符合2008年危机爆发之前的情况。
De nouveaux instruments financiers nés de la technologie ont créé des opportunités permettant à quelques-uns d’amasser des sommes considérables.	新技术支持的金融工具为某些人赚取巨额利润创造了机遇。
Or, les régulateurs ne sont pas parvenus à suivre le rythme des innovations, ce qui a fini par générer des risques qui ont affecté l’économie entière.	但监管机构却无法跟上创新的步伐，并最终酿成了影响整体经济的风险。
Intervient ici une différence fondamentale entre les crises mondiales du XXIe siècle et par exemple la Grande Dépression des années 1930, ou en réalité n’importe quel krach boursier passé.	这体现出21世纪的全球危机与20世纪30年代大萧条或过去任何一次股市崩盘之间的根本区别。
Compte tenu de la croissance du secteur financier, davantage d’acteurs bénéficient d’une sous-réglementation et d’une faible gouvernance à court terme, ce qui rend les crises d’aujourd’hui plus difficile à prévenir.	金融行业持续增长导致更多参与主体从短期监管不足和治理薄弱中获益，从而使人们更加难以预防现在的危机。
Ajoutant à cette complexité, les systèmes affectés par les crises contemporaines s’étendent au-delà de la compétence de n’importe quel organe réglementaire.	令问题更加复杂的是，受当前危机影响的系统远远超过任何一个监管机构的监管范围。
Les crises se révèlent ainsi encore plus ingérables, et leurs conséquences – y compris leur influence sur les sociétés et les politiques – plus difficiles à prédire.	这导致危机变得更加凶险，并导致人们更加难以对危机所产生后果 — — 包括社会和政治领域的长期后果 — — 进行预判。
Les prochaines crises – qui découleront probablement d’un nationalisme grandissant, ainsi que d’une absence croissante de prise en compte des sciences et prises de décisions politiques basées sur les faits – seront peut-être financières, mais elles pourraient impliquer également des aspects aussi divers que les migrations, le commerce, le cyberespace, la pollution et le changement climatique.	下一次危机 — — 因为民族主义情绪抬头和人们越来越无视基于科学和事实的决策而变得可能性愈来愈大 — — 可能涉及金融，但也可能涉及移民、贸易、网络空间、污染和气候变化等诸多领域。
Dans tous ces domaines, les institutions de gouvernance nationales et internationales sont faibles ou incomplètes, et rares sont les acteurs indépendants, tels que les groupes de vigilance, à exiger transparence et responsabilité.	在上述所有领域，国内和国际治理机构都力量薄弱或覆盖不完善，而且严重缺乏要求透明度和问责制的监督组织等独立行动主体。
Ceci rend plus difficile non seulement la prévention des crises – notamment parce qu’apparaissent des opportunités permettant aux acteurs de se jouer du système et de fuir leur responsabilité – mais également la réponse aux crises.	这不仅加大了预防危机的难度 — — 尤其因为它为参与者提供了钻空子和逃避责任的机会 — — 还使得人们越来越难以采取措施来应对危机。
Celle de 2008 a violemment mis en lumière combien nous échouons à répondre rapidement aux catastrophes, notamment à celles engendrées par une gouvernance fragmentée.	2008年危机暴露出我们在面对灾难时的快速反应有多么薄弱，尤其当造成灾难的主要原因是分散治理。
Bien entendu, comme le démontre le rapport 2018 de la Hertie School sur la gouvernance, des progrès ont été accomplis dans la prévention et la gestion des crises.	可以肯定，就像2018年赫蒂学院治理报告所表明的那样，人类在准备应对和管理危机方面取得了一定的进展。
Nous devons cependant nous montrer plus vigilants face au risque de voir des événements survenant dans des domaines très divers – de la finance aux technologies numériques en passant par le changement climatique – échapper aux capacités de gouvernance des institutions nationales et internationales.	但我们必须警惕更广泛领域的发展 — — 从金融到数字技术再到气候变化 — — 是以何种方式来规避国内和国际机构的治理监管。
Nous devons dresser des scénarios de crise, élaborer des plans d’urgence face aux éventualités de bouleversement dans tous les domaines, et prendre des mesures plus fortes pour atténuer les risques, notamment en gérant les niveaux de dette, qui demeurent aujourd’hui encore plus élevés qu’avant la crise de 2008 dans les économies développées.	我们应当在上述所有领域进行危机情景预演并制定危机爆发之际的紧急计划，同时采取包括管理债务水平等更强有力的措施来降低风险，今天发达经济体的债务水平均远高于2008年危机爆发之前。
Il nous faut par ailleurs veiller à conférer aux institutions internationales les ressources et les responsabilités nécessaires.	此外，我们应当确保赋予国际机构必要的监管责任和资源。
De même, en sanctionnant ceux qui accentuent les risques pour servir leurs propres intérêts, nous pourrions renforcer la légitimité de la gouvernance mondiale et des institutions censées la conduire.	通过对那些因为自身利益而加剧风险的人进行惩戒，我们可以强化全球治理及其责任落实机构的合法地位。
En l’état actuel des choses, une mauvaise coordination transfrontalière et une mise en application insuffisante des accords internationaux font considérablement obstacle à la prévention et gestion des crises.	目前，跨境协调和国际协定落实不充分是危机预防和管理的主要障碍。
Or, loin de remédier à cette fragilité, le monde renoue avec un modèle obsolète de souveraineté nationale qui plus probables encore les crises de différents types.	但世界各国正在重新兴起过时的国家主权模式不但没有解决这个问题，而且增大了各种危机的爆发风险。
À moins que nous changions rapidement de cap, le monde de 2118 aura toutes les raisons de nous regarder avec condescendance.	除非我们尽快改变方向，否则2118年的世界将有足够的理由来鄙视我们。
	
Les raisons de l'échec de 2008	2008年败在何处？
BERKELEY – Pour résoudre un problème, il ne suffit pas de savoir quoi faire.	伯克利—要解决问题，光知道做什么是不够的。
Il faut en outre mettre en œuvre la solution et être disposé à changer de cap s'il s'avère que vous n'étiez pas aussi bien renseigné que vous le pensiez.	你实际上必须实施解决办法 — — 并且在事实证明你知道的并不如你认为的那样多时，你得愿意改变办法。
C'est le message de deux livres récents qui à eux deux nous apprennent tout ce qu'il faut savoir sur la crise financière de 2008 : ce qui l'a provoquée, ce qui peut être fait pour empêcher qu'elle ne se reproduise et les raisons pour lesquelles ces choses restent encore à faire.	这就是两本新书一起告诉你的信息。 这两本新书讲述了你需要知道的关于2008年金融危机的一切：什么引起了金融危机，可以做什么防止它再次发生，以及为何这些事情还没有人去做。
Le premier livre est The Shifts and the Shocks, par le journaliste britannique conservateur Martin Wolf, qui commence par cataloguer les changements majeurs qui ont préparé le terrain pour le désastre économique qui continue de façonner notre monde actuel.	第一本书是《变化和冲击 》 （ The Shifts and the Shocks ） ， 作者是保守派英国记者马丁·沃尔夫（Martin Wolf ） 。
Son point de départ est la montée énorme des richesses parmi 0,1% et 0,01% des personnes les plus riches du monde et la pression qui en résulte pour les citoyens, les gouvernements et les entreprises qui doivent supporter des niveaux de dette de moins en moins durables.	在书的开头，他对酝酿了至今仍在影响世界的这场经济灾难的重要变化做了归纳编目。 首先，他指出世界最富有的0.1%和0.01%人群财富剧增，这给人民、政府和公司造成了日益不可持续的高负债的压力。
Pendant ce temps, les décideurs se sont bercés dans la complaisance de l'acceptation généralisée de théories économiques du type de « l'hypothèse du marché efficient », qui présuppose que les investisseurs agissent rationnellement et utilisent toutes les informations disponibles lors de leur prise de décision.	与此同时，决策者因为“有效市场假说”等经济理论的广泛接受而志得意满，有效市场假说认为投资者的行为是理性的，在作出决策时会利用一切可获得的信心。
En conséquence les marchés ont été déréglementés, ce qui a rendu plus facile à des actifs commerciaux d'être perçus comme inoffensifs, alors qu'en définitive ils ne l'étaient pas.	结果，市场监管被放松，交易被认为安全但实际并不安全的资产变得更加容易。
Ainsi le risque systémique a proliféré au-delà des plus folles espérances des dirigeants des banques centrales.	结果，系统性风险悄然酝酿，并且超过了央行官员最大胆的想象。
Les hypothèses non contestées et finalement erronées ont créé un environnement de projets politiques définissable uniquement sous le terme d'hubris.	未受检验并且最终错误的假设形成了一个只能用狂妄自大形容的决策环境。
Les pouvoirs publics ont sous-estimé les « risques extrêmes ».	官员低估了尾部风险。
Ils ont placé leurs objectifs d'inflation autour de 2%, laissant ainsi peu de place pour manœuvrer en cas de mer houleuse.	它们将通胀目标设定在2%左右 — — 这意味着当波涛汹涌时他们根本没有多少施展空间。
Mesure plus audacieuse encore, l'Union européenne a introduit l'euro comme monnaie commune.	此外，最大胆的动作要数欧盟引入欧元作为共同货币。
En effet, l'élaboration mal inspirée des mesures a continué longtemps après le début de la crise.	事实上，方向错误的决策在危机开始后仍然能维持了很长时间。
Les politiciens ont répondu à la dégradation des conditions économiques en se conformant toujours aussi strictement que possible aux recommandations qui avaient échoué, en veillant à ne rien faire de plus que le strict nécessaire pour traiter la plus grande catastrophe économique depuis la Crise de 1929.	政客对恶化的经济条件的反应是坚定实施错误的药方，对于这场大萧条以来最严重的经济灾难，他们除了绝对需要做的事情意外什么都不做。
La recommandation de Wolf pour contrer la crise est simple, intelligente et inattaquable.	沃尔夫给抵御这场危机开出的药方简单、明智并且无懈可击。
Dans l'immédiat, il suggère que les pays dotés de monnaies de réserve dépensent davantage (surtout pour financer les investissements publics) et émettent davantage de dette.	在短期，他建议拥有储备货币的国家增加支出（特别是公共部门投资融资 ） 、 发行更多债务。
Il soutient que leurs banques centrales doivent augmenter leurs objectifs d'inflation à 3% voire même à 4% par an.	他指出，这些国家的央行应该将通胀目标提高到每年3%甚至4 % 。
À moyen terme selon Wolf, les pays ont besoin de mettre en place des mesures réglementaires qui abaissent le niveau d'endettement et découragent le surendettement.	在中期，沃尔夫认为各国需要实施监管措施降低债务水平、阻止过度举债。
La zone euro doit elle aussi résoudre ses contradictions internes, soit par sa dissolution, soit en introduisant « un ensemble minimum d'institutions et de mesures » permettant à l'union monétaire de fonctionner correctement.	欧元区也必须解决其内部矛盾，要么通过解散欧元区实现，要么通过引入能令货币联盟正常运行的“最小限度的机构和政策组合”实现。
Les solutions à long terme de Wolf comprennent la lutte contre les inégalités, « une règlementation plus globale », une plus grande « liberté pour les différents pays dans l'élaboration de leurs propres réponses » et une analyse économique qui soit moins sous la coupe des idéologues du libéralisme qui nous ont conduits vers la crise.	沃尔夫的长期解决方案包括遏制不平等 、 “ 更加全球化的监管 ” 、 更大程度的“个体国家自己决定反应方式的自由”以及更少受到自由市场思想束缚的经济分析。 一开始正是自由市场思想让我们陷入了危机。
Pourtant aussi recommandables que les propositions de Wolf puissent paraître, peu d'efforts ont été faits pour les mettre en application.	但是，尽管沃尔夫的方案值得推荐，但几乎没有任何实施。
Les raisons à cela figurent dans le deuxième livre : Hall of Mirrors publié par mon ami, professeur et patron, Barry Eichengreen.	原因可以从第二本书中找到：由我的朋友、老师和“老板”巴里·艾肯格林（Barry Eichengreen）所著的《镜厅 》 （ Hall of Mirrors ） 。
Eichengreen retrace notre réponse tiède à la crise, le triomphe des économistes monétaristes disciples de Milton Friedman sur leurs pairs d'obédience keynésienne et minskyenne (au moins en ce qui concerne les interprétations des causes et des conséquences de la Crise de 1929).	艾肯格林认为，我们对这场危机反应不温不火，原因要追溯到作为弗里德曼（MiltonFriedman）门徒的���币经济学家对凯恩斯主义和明斯基（MInskyite）主义同行的胜利 — — 至少在解释大萧条的原因和后果方面是如此。
Lorsque la crise financière de 2008 a éclaté, les décideurs ont essayé d'appliquer les solutions proposées par Friedman pour résoudre la Crise de 1929.	2008年金融危机爆发时，决策者试图使用弗里德曼提出的大萧条方案。
Malheureusement cela s'est avéré un mauvais choix, puisque l'interprétation monétariste de la Crise de 1929, pour le dire crûment, a eu tort sur bien des aspects importants et s'est montrée radicalement incomplète.	不幸的是，事实证明这是错的，直言不讳地说，货币主义者对大萧条的解释在众多方面都是错误的，并且非常不完整。
Les mesures qui en ont résulté ont suffi à éviter que la récession post-2008 ne se transforme en une véritable dépression. Mais ce succès partiel s'est avéré être une victoire à la Pyrrhus, car il a permis aux politiciens de déclarer que la crise avait été surmontée et qu'il était temps de suivre des mesures d'austérité pour mieux se concentrer sur la réforme structurelle.	由此产生的政策足以阻止2008年后的衰退演变为完全的萧条；但这一局部成功的代价也是巨大的，它让政客宣布危机已经被克服，应该采取紧缩并专注于结构改革。
Il en résulte une économie actuelle stagnante, marquée par une croissance anémique qui menace de devenir la nouvelle norme.	结果就是现在的经济停滞，其特征是增长无力并且随时可能成为新常态。
Les États-Unis et l'Europe sont en passe d'avoir dilapidé 10% de leurs richesses potentielles, tandis que l'incapacité à renforcer la réglementation du secteur financier a laissé l'économie mondiale exposée au risque d'une autre crise majeure.	美国和欧洲损失了10%的潜在财富，而没有强化金融部门监管让世界经济随时可能迎来新一场大危机。
Wolf et Eichengreen conviendraient que les principales failles qui ont conduit à la crise financière de 2008 (et qui continuent d'étayer notre réponse insatisfaisante à cette crise) sont intellectuelles.	沃尔夫和艾肯格林会认为，导致2008年金融危机的主要缺陷 — — 以及继续破坏我们对危机的不充分反应的主要缺陷 — — 是知识缺陷。
En effet la seule vraie leçon de la crise semble être que jusqu'à aujourd'hui, les vraies leçons ne seront jamais vraiment tirées.	事实上，到目前为止，危机的唯一真正教训是它的教训从未被真正汲取。
	
La stratégie du retour de l'Europe	欧洲的重振战略
STOCKHOLM/MADRID – Lorsque le pape François Ier s'est adressé au Parlement Européen en novembre dernier, il a comparé l'Union européenne à une grand-mère : agréable et pleine d'expérience, mais dénuée de la vitalité et de l'énergie qu'elle a pu montrer jadis.	斯托克霍姆/马德里—去年11月，教皇方济各在其欧洲议会演讲中将欧盟比作祖母 — — 和蔼而富于经验，但已不再有过去的活力和能量。
Le pape a soutenu qu'il était grand temps que les dirigeants européens se défassent de leur manque de dynamisme, qu'ils reconnaissent les défis stratégiques auxquels l'Europe est confrontée et qu'ils conçoivent des mesures claires pour y faire face.	方济各说，现在是一个关键时刻，欧盟领导人必须摆脱懈怠形象，承认欧洲所面临的战略挑战，并构建应对挑战的明确政策。
Malheureusement le portrait dressé par le pape est juste à certains égards.	诚然，教皇的描述在某些角度讲非常准确。
Mais malgré sa lassitude apparente, l'Europe conserve des atouts importants.	但是，尽管欧洲看起来疲态尽露，但仍拥有巨大优势。
Elle est une plaque tournante de haut niveau pour la réflexion et l'innovation. Elle abrite certaines des régions et des industries les plus compétitives du monde et (fait peut-être encore plus impressionnant), elle représente une communauté et un marché regroupant un demi-milliard de personnes.	欧洲是高水平思想和创新的枢纽；是世界最有竞争力地区和产业的所在地；最重要的是，它还构建了一个由五亿人组成的社会和市场。
Mais le monde est en train de changer : la région Asie-Pacifique a de plus en plus d'influence dans les événements mondiaux, économiques et autres.	但世界正在变化：亚太地区正在日益影响全球经济和其他发展趋势。
L'Accord de Partenariat Trans-Pacifique, par lequel les États-Unis et 11 autres pays doivent créer une zone de libre-échange méga-régionale, va très probablement accélérer ce changement (ce qui va encore se confirmer si la Chine finit par les rejoindre).	跨太平洋合作伙伴关系（Trans-Pacific Partnership，TPP，由美国和其他11国建立的巨型地区自由贸易区）很有可能加速这一变革（如果中国最终也能加入就更加如此了 ） 。
Bien que le Partenariat Trans-Pacifique (PTP) contienne de nombreux obstacles à surmonter avant qu'un accord ne soit finalisé, il ne faut pas sous-estimer sa capacité à augmenter la puissance économique de l'Asie.	尽管TPP距离最终完成协议还有很多障碍需要跨越，但其扩大亚洲经济实力的潜力绝不容���觑。
L'Europe doit s'employer à renforcer sa position dans le nouvel ordre mondial, en commençant par relancer ses propres relations commerciales et ses investissements avec les États-Unis.	欧洲必须致力于确保其在新世界秩序中的地位 — — 首先要强化其自身与美国的贸易和投资联系。
Le problème est que malgré l'avancée des négociations du PTP, les pourparlers du Partenariat transatlantique de commerce et d'investissement (PTCI) entre l'UE et les États-Unis sont si profondément embourbés dans des controverses internes que l'ensemble du projet risque d'être sabordé.	在TPP谈判不断推进的同时，欧盟-美国跨大西洋贸易和投资伙伴关系（Transatlantic Trade and Investment Partnership，TTIP）谈判却深陷国内矛盾的掣肘，整个工程都有可能夭折。
Les chefs d'entreprises des deux côtés de l'Atlantique sont convaincus qu'un accord PTCI réussi apporterait des avantages économiques substantiels : une opinion étayée par de nombreuses études.	大西洋两岸的商业领袖相信，成功的TTIP协议将带来巨大的经济收益 — — 许多研究都强化了这一感觉。
Pourtant des questions triviales (par exemple, l'utilisation de poulet traité au chlore et le règlement de différends avec les investisseurs) continuent de dominer le débat.	但一些微妙的问题 — — 比如“氯化鸡 ” （ 欧洲怀疑美国鸡肉进入市场前都用氯消毒）和投资者纠纷和解等问题 — — 仍主导着争论。
L'objectif du PTCI est d'exploiter la puissance de l'économie transatlantique, qui reste de loin le plus grand et le plus riche marché du monde, représentant les trois-quarts de l'activité financière mondiale et plus de la moitié du commerce mondial.	TTIP的目标是释放跨大西洋经济的力量 — — 目前大西洋两岸仍是世界最大最富有的市场，占全球金融活动的四分之三和世界贸易量的一大半。
(Si le PTCI était ouvert à d'autres économies, comme la Turquie, le Mexique et le Canada, les avantages seraient encore plus grands.)	（如果TTIP向其他经济体开放 — — 比如土耳其、墨西哥和加拿大 — — 则收益还将更大。 ）
Il existe toutefois un argument encore plus convaincant que les avantages de parvenir à un accord : les conséquences potentiellement catastrophiques d'un échec.	但是，比达成协议的好处更加让人感到必须成功的是谈判失败可能带来的灾难性结果。
Pour commencer, une rupture des pourparlers du PTCI fournirait des arguments considérables aux membres du Royaume-Uni qui prônent le retrait de l'UE. Inversement, si le PTCI était mis en œuvre, il serait malavisé (et donc peu probable) que le Royaume-Uni sorte de l'UE.	首先，TTIP谈判的破裂将极大地加强英国鼓吹离开欧盟阵营的力量；反之，如果TTIP获得实施，英国离开欧盟将是不明智之举，因此也不会发生。
Par ailleurs, le sentiment que des querelles internes à l'UE ont conduit à gâcher une opportunité stratégique risquerait probablement de conduire les États-Unis à accélérer leur désengagement en faveur du continent.	此外，欧洲的内讧导致其白白浪费了一个战略机会，这一感觉可能促使美国加速远离欧洲。
Et le président russe Vladimir Poutine pourrait toujours considérer l'échec de l'Union européenne comme une opportunité majeure d'exercer plus d'influence sur certaines régions de l'Europe.	而俄罗斯总统普京也必然会将欧洲的失败视为影响欧洲更多地区的良机。
Tout cela contribue à un risque stratégique hautement fondamental : si le PTCI s'arrête ou s'effondre, tandis que le PTP va de l'avant et réussit, alors l'équilibre mondial va pencher fortement en faveur de l'Asie et l'Europe aura peu d'options, le cas échéant, pour retrouver une influence économique et géopolitique.	所有这些凸显出一个根本新战略风险：如果TTIP无法取得进展或失败，而TPP取得进展并成功，则全球平衡将朝着极有利于亚洲的方向发展 — — 欧洲极有可能无法重振其经济和地缘政治影响力。
Lorsque le PTCI a tout d'abord été proposé, l'Europe semblait reconnaître sa valeur.	TTIP首次提出时，欧洲似乎能够认识到其价值。
En effet, c'est l'UE qui a poussé les États-Unis, qui doutaient alors de l'engagement de l'Europe, à lancer le processus de négociations en juin 2013.	事实上，是欧洲推动一开始对欧洲的承诺有所怀疑的美国在2013年6月启动了谈判程序。
L'ambition était d'achever les négociations en un seul et même mouvement.	当时人们雄心万丈，意图“一鼓作气”完成谈判。
Personne ne voulait devoir supporter des pourparlers prolongés, ni les lourdeurs politiques qui en découlent.	没人想让谈判长久拖延 — — 或忍受因此带来的政治痛苦。
Mais les dirigeants de l'UE ont abandonné le fond du projet, confirmant ainsi en apparence les craintes américaines.	但欧盟领导人在事实上抛弃了这一工程，而这也印证了美国的担心。
Les négociateurs commerciaux ont eu du mal à progresser, tandis que les groupes anti-mondialisation ont pris le contrôle du discours public, en présentant le PTCI comme une menace pour tous les organes de l'Europe, depuis la démocratie jusqu'à ses services de santé.	贸易谈判在挣扎中前行，而反全球化组织掌握了公共观点的控制权，将TTIP描述为对一切事物的威胁 — — 从欧洲的民主到欧洲的健康莫不如此。
Cet exposé est dangereusement inexact et les dirigeants de l'UE doivent l'empêcher de gagner plus de terrain en en faisant un argument stratégique pour l'accord.	这是非常危险的错误言论，欧盟领导人必须拿出推进TTIP的战略性理由，从而阻止这一言论获得更大的市场。
Et ils doivent ranimer leur engagement à conclure les négociations avec succès en 2015.	他们还必须重振2015年成功完成谈判的承诺。
Cela ne veut pas dire que la résolution des questions en suspens dans les négociations du PTCI sera simple.	这并不是说解决TTIP谈判中仍然存在的问题轻而易举。
Mais établir un accord commercial, en particulier celui qui implique tant de questions réglementaires est toujours difficile, car il faut tenir compte de la complexité et de la variabilité des économies modernes.	但签订贸易协议，特别是包含如此多监管问题的贸易协议，永远不是件容易事，因为它必须考虑到现代经济的复杂性和易变性。
Le fait est que les défis inhérents à l'achèvement du PTCI ne sont pas plus difficiles à résoudre que ceux auxquels les dirigeants européens ont dû faire face au cours des dernières années de crise.	事实上，完成TTIP所包含的挑战并不比欧盟领导人在过去几年的危机中所遇到的挑战更棘手。
Quand vont reprendre les négociations du PTCI le mois prochain, les dirigeants européens devront faire pression pour entraîner un véritable progrès, avec l'objectif de parvenir à un accord d'ici la fin de l'année.	TTIP谈判将在下个月重启，届时欧盟领导人必须推动真正的进展，并以在年底完成协议为目标。
La bonne nouvelle, c'est que les récentes élections de mi-mandat aux États-Unis pourraient bien augmenter leurs chances.	好消息是最近的美国中期选举有可能增加他们成功的机会。
Le président Barack Obama pourrait obtenir à présent du Congrès le « pouvoir de négociation accélérée ».	现在，美国总统奥巴马可能将从国会获得所谓的快速谈判授权。
Si cela devait effectivement se produire, le Congrès pourrait tout simplement approuver ou rejeter tout accord négocié, plutôt que devoir le passer en revue.	果真如此的话，美国国会将对谈成的协议予以批准或否决，而不能束之高阁。
La période des élections présidentielles américaines commence et d'autres problèmes de cette nouvelle année pourraient facilement revenir en tête de l'ordre du jour de l'UE.	美国总统竞选季即将来开帷幕，在新的一年里，其他问题可能轻而易举地取代欧盟日程。
C'est pourquoi les dirigeants européens n'ont pas de temps à perdre.	正因如此，欧洲领导人已无时间可以浪费。
Ils doivent saisir les opportunités économiques et éviter un désastre stratégique.	他们必须抓住经济机会 — — 并避免战略灾难。
	
Les tests d'intelligence et la pensée rationnelle	理性对阵智力
TORONTO – En 2002, Daniel Kahneman, un spécialiste en psychologie cognitive de l'université de Princeton, a remporté le prix Nobel d'économie pour le travail qu'il a réalisé avec Amos Tversky, son collaborateur de longue date (mort en 1996).	多伦多 — 2002年，来自普林斯顿大学的认知科学家丹尼尔·卡纳曼获得了该年度的诺贝尔经济学奖，表彰他和长期合作者阿莫斯·特沃斯基（已经于1996年过世）所作的贡献。
Ils ont étudié notamment le processus de prise de décision – ce qui fait que nos pensées et nos actions sont rationnelles ou pas.	他们的工作针是针对判断和决策的：二者决定了我们的思想和行为是否理性。
Ils ont exploré la manière dont nous faisons des choix et évaluons des probabilités et ils ont mis en évidence les erreurs de base rencontrées couramment lors d'une prise de décision.	他们探究了人们怎样做出选择和评估可能，还揭示了在决策过程中典型的基本错误。
Ces erreurs ne relèvent pas de celles que l'on rencontre couramment dans les jeux de société.	他们所揭示的思维错误并不是客厅游戏里面的小过失。
Être rationnel suppose d'adopter des objectifs appropriés et d'agir en conséquence en se fondant sur des hypothèses compatibles avec les observations.	具有理性意味着确定适当的目标，并且基于个人的目标和信念来采取适当的行为，而且持有和可获得的证据相称的信念。
Cela signifie d'atteindre les buts que l'on s'est fixé en mettant en œuvre les meilleurs moyens pour y parvenir.	它还意味着采用尽可能最佳的手段来达成一个人的生活目标。
La violation des règles de la pensée qu'ont étudiées Kahneman et Tversky conduit à être moins satisfait de sa vie que ce que l'on pourrait l'être.	因此，如果违反卡纳曼和特沃斯基验证过的思考规律，就会带来实际后果：我们对生活的不满程度将会增大。
Les recherches menées dans mon propre laboratoire montrent qu'il y a des différences individuelles systématiques entre la capacité de jugement et la capacité de décision qu'ils ont étudiées.	在我自己实验室中进行的研究显示：在卡纳曼和特沃斯基研究过的判断和决策技能中，存在着系统性的个体差异。
Paradoxalement, le prix Nobel a été attribué pour des études de caractéristiques cognitives entièrement absentes des outils les plus connus utilisés dans les sciences du comportement : les tests d'intelligence.	具有讽刺意味的是，诺贝尔奖是针对就某些认知特征所作的研究而颁发的。 而在行为科学最广为人知的脑力评估 —智力测验里，这些认知特征却完全无影无踪。
Les scientifiques comme les gens ordinaires estiment que la pensée rationnelle inclut la capacité de jugement et le processus de décision – le type de raisonnement qui nous aide à atteindre nos objectifs.	科学家和外行人同样倾向于赞同“优质思维”包含着准确的判断力和决策力，这也是帮助我们达成目标的思维能力。
Pourtant, l'évaluation de cette faculté est totalement absente des tests de mesure de l'intelligence.	但是智力测验中却找不到针对这种优质的（理性的）思维的测定方式。
Ces tests mesurent des choses importantes, mais ils n'évaluent pas la capacité de raisonner rationnellement.	智力测验测试了很重要的东西，但是它们没有测量理性思维的程度。
Ce ne serait pas une omission grave si l'intelligence était un indicateur pertinent de la pensée rationnelle.	如果智商能够准确 预测 理性思维能力，这项省略也没什么大不了的。
Or mon groupe de recherche a découvert exactement l'opposé : dans le meilleur des cas c'est un indicateur médiocre et nombre des caractéristiques de la pensée rationnelle sont totalement dissociés de l'intelligence.	但我从自己的研究组别里得出的发现正好相反：智商最多只能部分预测理性，有些理性思维技巧还完全和智商无关。
Dans beaucoup de pays, les tests d'intelligence déterminent en grande partie la carrière scolaire, universitaire et professionnelle de millions de gens.	对于世界许多国家数以百万计的人而言，智力测验在很大程度上决定了他们的学术和职业生涯。
On y a recours lors des examens d'admission des enfants dans des classes réservées aux plus doués.	孩子们接受智力测验来决定是否能被学校录取进专为天才儿童所设的项目。
Les entreprises et l'armée utilisent des procédures de sélection et d'évaluation qui ne sont guère plus que des tests d'intelligence déguisés.	为公司和军队所倚重的测试和排序方法差不多就是隐形智力测验。
Il est sans doute nécessaire de s'intéresser dans une certaine mesure à l'intelligence, mais on a tendance à ignorer les capacités cognitives qui sont au moins aussi importantes, car la pensée rationnelle et l'action reposent sur elles.	也许必须对智力给予一些关注，然而忽略起码是同样重要的认知能力—这一趋势却不合理：正是这种能力支撑起理性的思维和行为。
Les critiques des tests d'intelligence soulignent depuis longtemps qu'ils laissent de côté une partie importante de l'activité intellectuelle, essentiellement des domaines non cognitifs comme les capacités socio-émotionelles, l'empathie et les aptitudes relationnelles.	长期以来，智力测验的批评家们已经指出这些测验忽略了精神生活的重要方面，主要是类似社会情感能力，情感转移能力和人际交流技能等非认知领域。
Mais ils échouent également à mesurer le fonctionnement cognitif, ce qui est évident si l'on observe qu'en dépit d'un QI élevé, beaucoup de personnes sont totalement incapables de penser ou de se comporter rationnellement.	然而，即使是作为认知功能的衡量方式，智力测验也很不全面，这可以通过一个简单的事实就体现出来：许多人虽然智商出众，但在理性思维和行为方面却体现出了彻底的无能。
Pour diverses raisons, nous en sommes venus à surévaluer les capacités mesurées par les tests d'intelligence et à sous-évaluer d'autres capacités cognitives importantes comme l'aptitude à la pensée rationnelle.	由于形形色色的原因，我们已经过分高估了那些由智力测验进行测试的思维能力，却低估了其他重要的认知技能，例如理性思维的能力。
Les psychologues ont étudié les principales erreurs de raisonnement qui rendent moins rationnels.	有些思维方面的错误导致人们进行非理性思考，心理学家已经对这些错误的主要类别进行了研究。
Ils ont identifié la tendance à évaluer les probabilités de manière incohérente, à trop faire confiance à une connaissance toute faite, à ignorer les hypothèses alternatives, à évaluer les données dont on dispose avec un préjugé en sa propre faveur, à afficher des préférences incohérentes en raison du "framing effect" (effet de l'influence), à accorder une importance excessive au bénéfice à court terme au détriment du bien-être à long terme, à décider en fonction d'un contexte qui n'a rien à voir, etc.	他们研究了人们的下列倾向：减缓对不连贯的可能性进行测试；在知识判断上过于自信；忽略对立假说；带着“我这边“的偏见来评估证据；因为框架效应而放慢自相矛盾的偏好；过分看重短期回报而牺牲长期福祉；允许决定受不相干的环境因素干扰，还有许多其他倾向。
Toutes ces formes d'erreur de la pensée rationnelle et de la prise de décision sont très mal corrélées avec l'intelligence – autrement dit, il est difficile de mesurer avec les tests de QI les différences individuelles dans le domaine de la pensée rationnelle.	所有这些类型的非理性判断和决策都与智商毫不相关，也就是说智力测验可能无法捕捉到理性思维方面的个体差异。
Les tests d'intelligence mesurent des capacités intellectuelles étudiées depuis longtemps, alors que les psychologues n'ont que depuis peu les outils leur permettant de mesurer la tendance à un mode de pensée plus ou moins rationnel.	智力测验评估的是脑力技能，这一技能已经被人们研究多时；而心理学家直到最近才找到测算理性和非理性思维倾向的工具。
Néanmoins, des progrès récents dans le domaine des sciences cognitives qui relève de la pensée rationnelle suggèrent que rien – si ce n'est l'argent – ne nous empêchera de construire un test d'intelligence rationnelle.	尽管如此，认知科学近来在理性思维研究上取得的进展意味着：没有什么因素—金钱除外—会阻止我们设立“RQ”测试（理性测试 ） 。
Un tel test pourrait se révéler très utile.	这种测试也许将被证明大有裨益。
Ainsi, de mauvaises décisions d'investissement sont liées à une trop grande confiance dans son propre jugement, à la tendance à trop vouloir expliquer les événements dus au hasard et à substituer l'émotion à la pensée.	例如，次优投资决定是和下列因素联系在一起的：在知识判断方面的过度自信，倾向于过度诠释机会事件，容易于用情感因素代替思考。
Des erreurs médicales et judiciaires sont liées aux tendances à la pensée irrationnelle étudiée par les psychologues.	医学和法律决策方面的错误同样与具体的非理性思维倾向相关，心理学家已经就此展开了研究。
Il existe des stratégies et des correcteurs environnementaux pour éviter ce type d'erreur, davantage liées à la rationalité qu'à l'intelligence.	在所有这些领域中，都存在策略和环境方面的困境来导致思考发生错误。 但是认识到这些思维错误更多是和理性而不是和智力相关，这一点十分重要。
Il y en aurait moins si les écoles, les entreprises et les gouvernements portaient davantage d'intérêt aux capacités cognitives ignorées par les tests d'intelligence.	如果学校，企业和政府对智力测验中缺失的认知能力给予关注，就能减少类似错误的发生。
Au lieu de cela, ces institutions consacrent beaucoup plus d'attention et de moyens à l'intelligence qu'à enseigner comment penser pour atteindre les objectifs que l'on se fixe.	不过，这些机构仍然把更多的注意力和资源用来关注智商，而不是用来教会人们为了达到目标应该如何进行思考。
C'est comme si l'intelligence était devenue emblématique de notre culture.	似乎智商已经变成了我们文化中的图腾。
Nous devrions plutôt développer les stratégies de raisonnement susceptibles d'améliorer substantiellement notre bien-être.	但是我们真正应该追求的是培养推理策略，它能极大地增加人类的幸福。
	
L’ascension de Zuma	祖马胜出
Les inquiétudes suscitées par l’élection de Jacob Zuma à la présidence de l’Afrique du Sud�occultent une étape très importante�: pour la première fois depuis des décennies, un champion des masses ordinaires est à la tête d’une nation sub-saharienne.	有些人对祖马当选南非总统的担忧，使一个重要的具有里程碑式意义的事件 — — 几十年来的第一次，一个撒哈拉以南非洲国家将会由一个支持平民大众的人当领导人 — — 蒙上了阴影。
La politique en Afrique est longtemps restée l’exclusivité des aristocrates, des soldats et des technocrates.	非洲政治长期以来都是贵族、军人和专家政治家的专属领域。
Même la propagation d’élections démocratiques n’a pas empêché les leaders régionaux de sortir des rangs de l’armée (Ouganda, Rwanda, Zimbabwe), d’être issus de dynasties (Togo, Kenya, etc.) ou d’être des professeurs d’université, des avocats ou des économistes (Ghana, Malawi, Liberia).	即使随着民主选举的发展，撒哈拉以南非洲国家的领导人一般也都是军人（例如乌干达、卢旺达和津巴布韦的领导人 ） ， 家族王朝（例如多哥、肯尼亚等国的领导人 ） ， 或者大学教授、律师和经济学家（例如加纳、马拉维、利比里亚的领导人）出身。
Voilà maintenant que l’Afrique du Sud, moteur économique de la région et siège de nombreuses universités, sociétés et médias importants, est dirigée par un ancien gardien de vaches, un leader hors du commun proche de tout un chacun.	现在，作为撒哈拉以南非洲国家经济引擎和最先进的大学、媒体以及公司所在地的南非，拥有了一位曾经当过牧羊人的领导人 — — 一位罕见的具有平易近人品质的非洲领导人。
La faculté de Zuma de se lier avec la population ordinaire est légendaire.	
Il est assez sûr de lui pour danser et chanter en public. Il parle une langue populiste et donne de l’espoir à la grande majorité de Sud-africains qui vivent dans de misérables conditions en terme de logement, d’éducation et de santé.	祖马在和普通民众打成一片方面具有超凡的能力，他在公开场合唱歌跳舞都很轻松自如，他用普通大众的语言进行演说，他为广大每天忍受恶劣的居住、教育和医疗条件的南非人带来了希望。
A l’opposé de ses deux prédécesseurs – Nelson Mandela le béatifié qui a mis l’accent sur la fin du conflit racial et l’aristocrate Thabo Mbeki, dont la maîtrise de la macroéconomie a rassuré les financiers – Zuma reconnaît la demande sous-jacente d’améliorer les conditions de vie matérielles des dix millions d’indigents du pays. «�Les erreurs commises au cours des 15 dernières années nous ont beaucoup appris, notamment la manière dont nous avons, dans une certaine mesure, négligé l’évolution de la population » a-t-il déclaré en avril, avant que son parti n’emporte la victoire.	祖马和他的两位前任 — — 强调种族愈合的品德高尚的尼尔森·曼德拉和通过对宏观经济强有力的把握打消金融家顾虑的贵族化的塔博·姆贝基 — — 不同，他认识到了南非几千万穷人被抑制的改善物质生活条件的需求。 “我们已经从过去15年的错误中，特别是从在某种程度上忽略了人民运动的错误中，吸取了教训 。 ”
	他在四月份于非洲国民大会党横扫对手取得胜利之前，如是说。
Jusqu’à aujourd’hui, le populisme faisait défaut à la culture politique africaine.	直到现在，非洲政治文化中仍然缺乏平民主义的观念。
Zuma, qui a passé sa jeunesse à garder des troupeaux sans recevoir d’éducation formelle, sauf dans la prison de Robben Island en présence de Mandela, est tout à fait conscient que le plus gros problème de l’Afrique est dû à ses inégalités et non à sa marginalisation mondiale.	祖马的青年时代是在放牧中度过的，他直到和曼德拉一起被关押在了臭名昭著的罗宾岛（Robben Island）监狱之后，才接受正式的教育的；祖马清醒地认识到，非洲最大的问题是不平等问题，而不是在世界上被边缘化了的问题。
Cet impudent démagogue détient désormais le pouvoir absolu sur la politique du gouvernement du pays africain le plus riche - qui est aussi la nation où les richesses sont les moins bien réparties.	在非洲最富裕的国家，但是也是财富分配最不公平的国家 — — 南非，一个大胆的平民主义者现在对政府政策拥有了最终决策的权力了。
Mais, tandis que le populisme de Zuma se fait le reflet des énormes disparités sud-africaines, surtout sociales, la menace d’imposer des taxes plus élevées et d’autres obligations sur les patrons et les nantis suscite la peur, à l'échelle nationale et internationale.	然而，虽然祖马的平民主义吸引力反映了南非特别巨大的经济阶层差异，但是，他扬言要对雇主和富人征收更高的税赋和施加其他的义务，已经在南非国内外引起了人们的担心。
En outre, Zuma, surnommé le «�caméléon�», est accusé de dire à son public ce que ce dernier souhaite entendre.	而且，还有人将祖马称为变色龙，指责他总是向听众讲他们想听的东西。
Sa vie privée pour le moins sulfureuse – de nombreuses femmes et une déclaration embarrassante lors de son jugement pour viol précisant qu’il s’était protégé du sida en prenant une douche – suscite le ridicule.	祖马混乱的私生活 — — 他有多位妻子，以及他在一起强奸审判中说他通过淋浴避免艾滋病病毒的令人尴尬的辩解 — — 已经引起了一些人的嘲笑。
Qui plus est, des doutes demeurent sur son engagement démocratique, lorsque les critiques le traitent de «�grand homme�» africain de la vieille école, prêt à tyranniser ses adversaires et à piller les caisses publiques avec ses camarades.	更严重的是，有人对他的民主承诺一直持怀疑态度，也有批评家批评他是一个老式的非洲“专制人物 ” ， 认为他会威吓对手并与其亲信一起侵占公共财产。
Pour dissiper les plaintes, Zuma insiste�: «�Aucun nuage ne [l’]entoure�».	为了驳斥这些批评，祖马坚称 ， “ 我是光明正大的 。 ”
Pendant ce temps, ses défenseurs mettent le doigt sur deux avantages qu’il a déjà apportés�: la fin de la politique ambivalente de Mbeki pour lutter contre le sida, la menace à la santé la plus importante du pays, et une volonté bienvenue de s'opposer au vieux dictateur du Zimbabwe, Robert Mugabe, que Mbeki a dorloté – fallacieusement – afin de rester loyal au soutien qu’il a apporté durant la lutte contre l’apartheid.	同时，他的支持者也向人们指出了两个他已经承诺过的好处：结束姆贝基对抗南非主要的公共健康威胁 — — 艾滋病病毒/艾滋病 — — 的充满矛盾的做法，用行动反对津巴布韦年迈的独裁者罗伯特·穆加贝的全新观点 — — 对于罗伯特·穆加贝，姆贝基因为其在南非反对种族隔离制度时期给予反种族隔离制度人士的支持而对其产生了具有误导性的信任，因而纵容他的独裁统治。
Dans une Afrique privée de démagogues à succès, Zuma s’est sûrement inspire des personnalités d’Amérique latine, où l’inégalité des revenus est aussi extrême et où le mouvement syndicaliste, tout comme en Afrique du Sud, est solide et actif.	在缺乏成功的平民主义政治家的非洲，祖马的行为榜样可能来源于拉丁美洲。 在拉丁美洲，收入不平等问题也是极端严重的，而且，工会运动和南非一样，非常强大而好战。
Zuma, l’ami du peuple, va vite être mis à l’épreuve par l’énorme pression exercée par les couches ordinaires vers des résultats concrets : suivra-t-il l’exemple de Lula au Brésil, qui a su admirablement bien concilier bonne gouvernance économique et redistribution des richesses ?	因为来自普通民众要求给予切实好处的巨大压力，平民主义者祖马很快就会面临一个重大考验：他是效仿巴西的卢拉，在良好的经济治理和将财富重新分配给穷人间取得令人钦佩的平衡呢？
Empruntera-t-il le chemin de Hugo Chávez, autocrate populaire qui préfère, semble-t-il, cultiver le culte de sa personnalité plutôt que d’augmenter le niveau de vie des plus démunis�?	还是会走上一条雨果·查韦斯式的道路，做一个受欢迎的独裁者，和提高穷人的生活水平相比，更愿意建立起个人崇拜呢？
Pour l’Afrique, les enjeux sont considérables.	这对非洲厉害攸关。
L’Afrique du sud possède la plus forte économie du continent et, jusqu'à la crise financière mondiale, a affiché 10 ans durant une belle croissance économique.	南非是非洲最大的经济体，并且，在经济危机爆发之前的十年里，经济稳定增长。
Par temps de récession, la grande question de la criminalité dans se pays, ne pourrait qu’empirer, à l’instar du chômage, qui dépasse les 20�% d’une économie traditionnelle.	在经济低迷时期，南非严重的犯罪问题肯定会恶化；而且，已经在正式经济体中占前20%的失业问题，也会恶化。
Zuma ressent l’urgence de la situation.	祖马意识到了问题的紧迫性。
Après tout, il a 67 ans et ne servira probablement qu’un seul mandat. «�Nous ne pouvons nous permettre de perdre du temps�» a-t-il déclaré.	毕竟，他已经67岁了，不大可能会连任。 他说 ， “ 我们不能浪费时间 。 ”
Toutefois, d’après l’économiste politique Moeletsi Mbeki, au fond, «�Zuma est un conservateur.�» Vu sous cet angle, Zuma représente l’Afrique du Sud d’hier.	然而，根据政治经济学家莫莱茨·姆贝基(Moeletsi Mbeki)的观点，在本质上 ， “ 祖马是一个保守主义者 。 ” 在这个意义上，祖马代表的是过去的南非。
Il fait partie de la génération fière d’avoir vaincu l’apartheid, puis d’avoir opéré une transition pacifique vers une administration à majorité noire, ce qui demeure une des plus grandes réussites de l’histoire contemporaine.	他是打败种族隔离制度 — — 然后让南非和平过渡到由人口占多数的黑人进行长期统治 — — 的自豪的一代人的一部分。 这一代人的成就是现代��史上最伟大的成就之一。
Mais il semblerait cependant que cette génération révolutionnaire rencontre des difficultés à diriger l’Afrique du Sud 15 ans après la fin de l'apartheid.	同时，祖马革命的一代似乎对领导打破种族隔离制度15年后的南非，还不适应。
Dans une région qui révère les personnes âgées, l’attachement de Zuma aux traditions rurales doit être compensé par autant d’ouverture à l'appétit des jeunes du pays.	在一个尊敬老人的地区，祖马对其乡下传统的依恋，必须和对南非年青人的爱好所持的平等而开放态度相平衡。
3 Sud-africains sur 10 ont moins de 15 ans, ce qui signifie qu’ils n’ont pas connu l’apartheid.	在南非，每10个人中就有三个人的年龄小于15岁，这意味着，这些人从来没有在种族隔离制度下生活过。
D’une manière ou d’une autre, Zuma doit trouver un moyen d’honorer l’engagement de sa propre génération pour la justice raciale et la libéralisation du pays, tout en donnant du pouvoir aux masses qui souffrent des disparités sociales au quotidien et qui aspirent à plus de gains matériels.	在某种程度上，祖马在给予那些心灵每天都会被阶层差异刺痛以及渴望物质利益的广大民众权利的同时，他还必须找到一个实践自己那一代人所作的种族公正和民族解放承诺的途径。
	
Le Pacte de croissance dysfonctionnel de l’Europe	欧洲功能失调的增长契约
BRUXELLES – Un trou de près de 10 milliards d’euros est récemment apparu dans le budget de l’Union européenne de cette année.	布鲁塞尔—最近，本年度欧盟预算的100亿欧元缺口被曝了光。
En conséquence, l’UE ne peut plus rembourser les États membres pour des dépenses exceptionnelles, dont les frais d’urgence, tels l’aide aux victimes italiennes du tremblement de terre, ni financer les dépenses visant à soutenir la croissance économique et l’emploi, comme l’absorption accélérée des Fonds structurels et de cohésion inutilisés.	结果，欧盟无法偿还成员国近期计划外支出，包括紧急支出（如意大利地震灾区援助）以及旨在提振经济增长和就业的支出（如未使用结构和凝聚基金（Structural and Cohesion Funds）的加速吸收 ） 。
Les États membres ont opposé un refus à la demande de la Commission européenne de contributions supplémentaires pour combler ce trou, menant à l’impasse des discussions sur le budget 2013.	成员国拒绝欧盟委员会增加出资弥补资金缺口的要求，导致明年预算谈判崩溃。
Dans l’intervalle, les négociations sur le cadre financier pluriannuel 2014-2020 (CFP), le principal instrument de planification de l’utilisation des fonds de l’UE, ont également achoppé à cause de désaccords sur des questions clés, notamment la taille du budget et l’allocation des dépenses.	与此同时，2014—2020多年度财政框架（MFF，欧盟基金使用的中央规划工具）也由于在包括预算规模和支出组成等关键问题上的分歧而无法维持。
La décision a été reportée au début de l’année prochaine.	决定被推迟到明年初。
La situation souligne l’ambiguïté entourant le rôle du budget de l’UE dans l’intégration européenne.	这一状况凸显出欧盟预算在欧洲一体化进程中作用不清。
Bien que tous les chefs d’État et de gouvernement de l’UE aient défendu l’idée d’utiliser le budget pour stimuler la croissance économique, peu de mesures concrètes ont été prises.	尽管所有欧盟领导人都支持用预算来刺激经济增长，但行动者寥寥。
Cette conjoncture soulève des doutes quant au pacte sur la croissance et l’emploi adopté par le Conseil européen en juin dernier, et en particulier quant à l’engagement politique à mobiliser rapidement 120 milliards d’euros en réaffectant les Fonds structurels et de cohésion inutilisés et en augmentant la capacité de prêt de la Banque européenne d’investissement.	这引起了人们对欧洲委员会6月提出的所谓的“增长契约”的质疑，特别是其中通过重新配置未使用的结构和凝聚基金以及增加欧洲投资银行（European Investment Bank）的贷款能力迅速动员1200亿欧元的政治承诺。
En fait, alors que les gouvernements européens ont convenu d’encourager une absorption plus rapide des fonds communautaires par les pays en difficulté, ils ont refusé d’apporter les contributions au budget de l’UE permettant de débourser ces fonds.	事实上，尽管欧洲各国政府同意鼓励快速回收危机国的欧盟基金，但它们拒绝向欧盟预算注资以满足这些基金的支出。
Cette contradiction montre que les intérêts nationaux continuent à prévaloir dans les négociations budgétaires européennes, souvent exploitées par les États membres pour des gains politiques nationaux.	这一矛盾表明，国家利益仍广泛存在于欧盟预算谈判中，成员国总是将谈判当作争取本国政治利益的工具。
A moins qu’un mécanisme soit introduit pour faciliter l’allocation rapide des fonds communautaires, protégeant ainsi le budget de l’UE d’une politisation destructrice, ces fonds ne pourront pas être utilisé pour stimuler la croissance en période de crise.	除非引入能够促使欧盟基金快速支出的机制，从而让预算免于毁灭性的政治化，欧盟基金将无法被用于在危机时刺激增长。
Les États membres ne contribuent pas tous de manière égale au budget de l’UE. Certains sont des contributeurs nets, d’autres des bénéficiaires nets.	各成员国对欧盟预算的出资并不是对等的；一些国家是净贡献者，一些国家是净受益者。
Une fois que les projets d’investissements financés par l’UE sont définis – dont les dépenses sont convenues et exécutées dans le cadre du budget annuel – l’argent est transféré au bénéficiaire.	在欧盟出资的投资项目结束时 — — 期支出在年度预算框架内同意并执行 — — 资金便被转移给了净受益者。
Les montants perçus par les bénéficiaires nets sont versés par les contributeurs nets.	而净受益者所得到的资金是由净贡献者出资的。
Une entrée de fonds de l’UE dans un pays implique donc une sortie de fonds d’un autre pays – et il s’agit ici de subventions, pas de prêts.	于是，一国对欧盟资金的流入便是另一国的流出 — — 是资助，不是贷款。
L’accord conclu tous les sept ans sur les dépenses générales ne suffit donc pas à empêcher les conflits sur le budget annuel.	结果，每七年签一次总体支出协议并不足以排除年度预算冲突。
Il n’en reste pas moins que des mesures peuvent être prises pour prévenir l’impasse des négociations budgétaires, tout au augmentant la flexibilité du budget de façon à ce qu’il puisse stimuler la croissance.	尽管如此，可以采取一些步骤防止在预算谈判中发生政治僵局，同时提高预算的灵活性，以使其能够用于刺激增长。
Par exemple, une partie du budget pourrait être utilisée pour contracter des emprunts, malgré la controverse inévitable, puisque les traités de l’UE exigent que le budget soit équilibré en permanence.	比如，可以允许预算使用杠杆，尽管这会引起激烈的争论，因为欧盟条约要求预算随时保持平衡。
Le budget de l’UE permet pourtant déjà une forme indirecte d’endettement : l’utilisation par la Commission européenne des garanties implicites offertes par le budget de l’UE pour lever des fonds sur les marchés financiers.	但欧盟预算已经包含着间接的杠杆形式：欧盟委员会利用隐含的预算担保在金融市场上筹集资本。
Ces fonds sont utilisés pour venir en aide à des pays n’appartenant pas à la zone euro par le biais du Mécanisme de soutien financier à moyen terme des balances des paiements, à des pays de la zone euro par le biais du Mécanisme européen de stabilité financière (MESF), aujourd’hui défunt, et à des pays tiers partenaires.	这些资金被用于通过中期金融援助便利（Medium-Term Financial Assistance Facility，MTFA）向非欧元区欧盟国家提供金融援助、通过现已过期的欧洲金融稳定机制（MFSM）向欧元区成员国提供援助以及与其他国家组成伙伴关系。
Entre le Mécanisme de soutien financier à moyen terme, le MESF et les paiements au pays tiers, le total des expositions s’est élevé cette année à 70,5 milliards d’euros.	在MTFA、EFSM和向第三方国家支付之间，今年的总敞口是705亿欧元。
Des emprunts contractés sur la période de sept ans du Cadre financier pluriannuel seraient possibles tout en respectant l’objectif à moyen terme de l’équilibre budgétaire.	在七年的MFF期限中进行一定程度的借贷是可能的，与此同时，还能支持平衡预算的中期目标。
Cette utilisation du budget pour lever des fonds compléterait le mécanisme européen de stabilité (MES), récemment créé (et qui succède au MESF) et le mécanisme de soutien à moyen terme.	此类欧盟预算杠杆可以补充最近出台的欧洲稳定机制（ESM，EFSM的后续机制）和MTFA。
Les pays bénéficiant d’une aide devraient avoir la possibilité de demander une mise à disposition anticipée des fonds de l’UE.	获得���著的国家应被授予申请未来欧盟资金开支的选择权。
A la suite d’une demande d’un État membre, la Commission européenne serait autorisée à emprunter sur les marchés financiers, emprunts implicitement garantis par le budget de l'Union européenne. Le montant total serait déterminé par la taille des Fonds structurels et de cohésion inutilisés (avant allocation) du pays concerné.	应成员国要求，欧盟委员会将得到授权，以欧盟预算为隐含担保在资本市场上借钱，最大金额由该国未使用（配置前）结构和凝聚基金规模决定。
Les paiements dus seraient versés en tranches annuelles à mesure que les fonds deviennent disponibles par l’entremise du budget de l’UE, tandis que le taux de cofinancement national s’appliquerait aux paiements des intérêts.	因为基金在欧盟预算期间都可获得，因此这笔资本将通过每年分期付款偿还，而利息支付将采用该国共同融资利率。
Ce cadre devrait réduire les incitations à se servir des négociations budgétaires annuelles pour faire progresser des objectifs politiques nationaux.	该框架将削弱利用年度欧盟预算谈判行使政治图谋的激励。
Les contributeurs nets seraient dans une relation captive avec les marchés – un créditeur convaincant.	净出资国将被锁定在市场关系中 — — 可信的债权人。
Dans le même temps, imposer des conditions à cette mise à disposition des fonds améliorerait la légitimité des conditions dans lesquelles les bénéficiaires font valoir leurs droits, contrairement au cadre actuel.	与此同时，为这类开支设定条件将增强合法性，而现有框架正好相反，受益国会寻求福利。
En fait, tous les pays de l’UE – pas seulement les membres de la zone euro – bénéficieraient de telles conditions.	事实上，所有欧盟国家 — — 不只是欧元区成员国 — — 都能从这样的框架中受益。
Une initiative de la sorte pourrait cohabiter avec la proposition du président du Conseil européen Herman Van Rompuy de créer un mécanisme de financement du partage des risques (MFPR) pour les pays de la zone euro.	这一方案可以和欧洲委员会主席范龙佩关于建立欧元区国家专属风险共担机制的方案共存。
Un pacte pour la croissance revu et corrigé permettrait une meilleure allocation des ressources européenne et améliorerait la flexibilité des transferts permanents des pays riches vers les pays pauvres – pour autant que ces montants soient consacrés à des investissements productifs.	修改后的增长条约将更有效地配置欧洲的资源、增加从富国到穷国的转移支付的灵活性 — — 只要这笔钱被用于生产性投资。
La proposition de budget de Van Rompuy pourrait aussi contribuer à stabiliser la zone euro dans le cas où des chocs asymétriques obligeraient à transférer des fonds de pays préservés à des pays en difficulté.	范龙佩的预算方案还有助于在不对称冲击要求未受影响国家向危机袭击国家进行转移支付时稳定欧元。
En fait, les deux instruments pourraient bien être complémentaires dans les pays de la zone euro.	事实上，这两样工具可以在欧元区国家完美共存。
Les crises s’accompagnent en général d’une chute non seulement de la croissance, mais également du potentiel de croissance d’un pays, en raison d’investissements différés.	危机通常不仅伴随实际增长的下降，也伴随增长潜力的下降（因投资不振导致 ） 。
Un mécanisme de financement du partage des risques pourrait limiter le déclin de la croissance réelle après une crise, tandis que des investissements rapides et financés par l’UE pourraient empêcher qu’un pays se retrouve sur une trajectoire de croissance plus lente.	风险共担便利能够限制危机后的世纪增长下跌幅度，与此同时，及时的欧盟融资投资项目能够防止防止一国向更低的增长路径迁移。
	
Financer la coopération internationale	为国际合作提供融资
NEW YORK – Aujourd'hui, la fourniture de biens et services publics aux niveaux mondial et régional est dangereusement insuffisante.	纽约—如今，全球和地区层面的公共品和服务提供非常不足。
Le système des Nations Unies, l'Union européenne et d'autres organisations multilatérales sont en péril, parce que leurs budgets sont insuffisants pour répondre à leurs responsabilités.	联合国体系、欧盟和其他多边组织都承受着很大的压力，因为它们的预算不足以满足责任。
Bien que quelques idéologues du libre marché puissent encore expliquer que les entreprises motivées par le profit devraient diriger le monde en l’absence de gouvernement, l'expérience prouve le contraire.	一些自由市场理论家可能仍然认为，应该由以利润为动机的公司，而不是政府来运转世界，但经验表明绝非如此。
Les gouvernements sont essentiels pour assurer un accès universel aux services essentiels tels que la santé et l'éducation; construire des infrastructures telles que les routes, les voies ferrées et le réseau électrique; et financer la recherche scientifique et les technologies à un stade précoce.	在提供健康和教育等全民重要服务；高速公路、铁路和电网等基础设施；以及科学研究和早期技术等拨款方面，政府起着不可或缺的作用。
Les gouvernements sont également nécessaires pour taxer les riches et transférer du revenu aux pauvres.	向富人征税然后将收入转移给穷人也需要政府。
Sinon, nos sociétés deviendront dangereusement inégales, injustes et instables – comme cela est en train de se produire aujourd'hui aux États-Unis.	否则，我们的社会将变得非常危险，不平等、不公正、不稳定 — — 就像今天的美国。
Les gouvernements des pays à revenu élevé prospères collectent au moins 25% du revenu national au moyen d’impôts afin de mener à bien ces fonctions.	成功的高收入国家的政府至少要对国民收入课以25%的税收，才能实现这些功能。
Dans les économies les plus prospères du monde, notamment les démocraties sociales de l'Europe du Nord, les gouvernements taxent environ 50% du revenu national.	在世界最成功的的经济体中 — — 主要是北欧社会民主国家 — — 国民收入的50%都被政府征用为税收。
Ils utilisent ces revenus pour trois fonctions vitales: les services publics, les investissements publics et des paiements de transfert des riches vers les pauvres.	它们用这些收入行使三大关键功能：公共服务、公共投资，以及从富到穷的转移支付。
Ces trois fonctions publiques sont nécessaires de manière urgente au-delà du niveau national.	急需这三大公共功能的不仅限于国家层面。
Des groupes de pays voisins – comme l'UE et l'Union africaine (UA) – ont besoin de services publics, d’investissements publics et de paiements de transfert qui traversent les frontières nationales et qui impliquent souvent des dizaines de pays en même temps.	邻近国家组成的联盟 — — 如欧盟和非盟 — — 需要跨境公共服务、公共投资和转移支付，并且常常同时涉及到几十个国家。
Les groupes régionaux ont besoin de budgets régionaux adéquats pour mener à bien leurs fonctions vitales.	地区集团需要足够的地区预算实现关键功能。
De la même manière, l'ONU dans son ensemble a besoin d'un budget suffisant pour financer les efforts mondiaux pour lutter contre le changement climatique, protéger les océans, mettre fin à l'extrême pauvreté, résister à la prolifération nucléaire et mettre fin aux conflits locaux au travers du Conseil de sécurité avant qu'ils ne deviennent des catastrophes mondiales.	同样地，联合国作为一个整体，也需要足够的预算为遏制气候变化、保护海洋、消除贫困、阻止核扩散以及通过安理会在冲突演变为全球灾难之前扑灭等方面的全球措施提供资金。
L'UE, l'UA et d'autres groupes régionaux devraient construire des réseaux électriques régionaux basés sur les énergies renouvelables (comme l'énergie éolienne, solaire et hydraulique) au lieu de combustibles fossiles.	欧盟、非盟和其他地区集团应该构建基于可再生能源（如风能、太阳能和水能）而非化石燃料的地区电网。
Ces groupes devraient également transférer des fonds des régions les plus riches vers les régions les plus pauvres afin d'éliminer les poches de pauvreté persistante.	这些集团还应该讲资金从最富裕地区转移到最贫穷地区，以消除持续贫困。
De plus, ils devraient protéger la nature sans s’arrêter aux frontières et investir beaucoup plus dans la science et la technologie pour tirer profit de la révolution numérique.	它们应该超越国界保护自然，加大科学技术投资力度以利用数字革命。
Pourtant, les ressources budgétaires disponibles pour cette coopération multilatérale sont une bouchée de pain.	但这些多边合作可以动用的预算资源十分稀缺。
Alors que de nombreux États membres de l'UE taxent au moins 25% du revenu national en vue de financer des dépenses publiques aux niveaux national et local, les fonds disponibles pour le budget de l'UE dans son ensemble équivalent seulement à 1% du revenu combiné des pays membres.	许多欧盟成员国对国民收入课以25%或以上的税收，以满足国家和地方层面的公共支出，而可用于欧盟预算的资金只占成员国总国民收入的1 % 。
Des fonds supplémentaires sont disponibles par le biais de la Banque européenne d'investissement, mais ceux-ci sont réservés aux projets d'investissement qui peuvent être financés sur une base de marché.	欧洲投资银行可以提供更多的资金，但只是面向能够按市场标准融资的投资项目。
La raison du sous-financement est évidente.	资金不足的原因是显而易见的。
Les taxes sont de la compétence des gouvernements nationaux et locaux, qui gardent jalousement leurs prérogatives fiscales.	税收在国家和地方政府管辖区域征收，它们激烈地保护着自己的税收特权。
Les gouvernements nationaux ont convenu de transférer seulement 1% du revenu national à Bruxelles pour financer des projets à l'échelle européenne.	国家政府只同意将国民收入的1%转移给布鲁塞尔用于欧盟层面的目的。
Le résultat est une UE avec des aspirations très grandes et un très petit budget de fonctionnement.	结果是欧盟空有雄心壮志，却囊中羞涩。
Pire encore, les nationalistes en Europe (comme les Brexiteers du Royaume-Uni) affirment que le budget de l'UE est trop grand, et non pas lamentablement petit.	更糟糕的是，欧洲民族主义者（如英国的退欧派）宣称欧盟预算过于庞大，而不是太小。
Aucun pays ne peut survivre avec seulement 1% du revenu national.	没有一个国家能够坚持拿出区区1%的国民收入。
Et il se pourrait que l'UE, elle aussi, ne parvienne pas à se maintenir sur un aussi petit budget.	欧盟也很有可能连这个微小的预算也无法自己维持。
Les services publics, les investissements et les transferts à l'échelle européenne sont une infime partie de ce qui est nécessaire pour avoir une union vraiment efficace.	欧盟层面的公共服务、投资和转移支付相对真正有效的联盟所要求的的水平，只是九牛一毛。
La situation est encore plus grave au niveau mondial.	而全球层面的情况甚至更加糟糕。
Le budget ordinaire de l'ONU ne s’élève qu’à 2,7 milliards de dollars par an, soit seulement 0,003% du revenu total mondial de 90 billions de dollars.	联合国常规预算只有每年27亿美元，或世界90万亿美元总收入的0.003 % 。
Son budget annuel total, y compris les contributions supplémentaires des Etats membres pour les opérations humanitaires et de maintien, est d'environ 50 milliards de dollars, soit 0,06% du revenu mondial – une fraction des besoins réels.	其年度总收入，包括成员国为维和和人道主义行到所缴纳的附加会费，大约在500亿美元，或世界总收入的0.06 % — —远远比不上真实需求。
Les états membres de l'ONU adoptent à juste titre des mesures audacieuses telles que les objectifs de développement durable et l'Accord de Paris sur le climat, mais n’ont pas les moyens financiers pour les mettre en œuvre.	联合国成员国正确地采取了果断的措施，如可持续发展目标（SDG）和巴黎气候协定，但缺乏实施这些措施的金融手段。
Même si le budget de l'ONU est faible, le gouvernement américain attaque régulièrement l'institution pour être démesurée et trop chère.	虽然联合国预算规模很小，但美国政府总是攻击联合国机构臃肿，铺张浪费。
Les États-Unis paient environ 22% du budget ordinaire annuel de 2,7 de milliards de dollars, soit environ 600 millions de dollars par an. Néanmoins, cela représente moins de 2 dollars par Américain!	美国大约缴纳了其27亿美元常规预算的22 % ， 或每年6亿美元，但平均到每个美国人头上，还不到2美元！
Si on ajoute les paiements au titre du maintien de la paix et les autres dépenses, la contribution annuelle totale des États-Unis est d’environ 10 milliards de dollars, soit environ 30 dollars par habitant.	加上维和和其他支出，美国每年缴纳的联合国会费大约在100亿美元，或人均30美元。
En étant si avares, les Etats-Unis ne se rendent pas service.	如此吝啬让美国砸了自己的脚。
Les coûts finaux pour les États-Unis, et le monde, liés au sous-investissement chronique dans les besoins mondiaux pourraient atteindre des dizaines de billions de dollars.	全球投资需求长期得不到满足给美国以及世界所造成的最终成本可能高达数十万亿美元。
En plus des paiements au-travers de l'ONU, les pays à revenu élevé font des paiements directs à destination des pays les plus pauvres sous forme d'aide publique au développement.	除了通过联合国实现的支出，高收入国家还以官方发展援助（ODA）的形式直接向穷国支付。
L'APD nette combinée totalise environ 150 milliards de dollars par an, soit 0,31% du revenu des pays donateurs, à comparer au niveau de 0,7% du revenu longtemps promis pour l'APD.	每年的总ODA净值大约在1,500亿美元，或出资国总收入的0.3 % ； 而ODA长期承诺占出资国总收入的比例为0.7 % 。
Étant donné la faiblesse de ces transferts globaux, l'extrême pauvreté persiste dans un monde d'abondance.	由于这些全球支付规模过小，极端贫困仍然遍布全球。
De plus, les promesses de longue date des pays riches de fournir aux pays pauvres au moins 100 milliards de dollars par an pour financer des dépenses liées au changement climatique sont restées lettre morte jusqu’à ce jour.	而富裕国家早就做出的每年向穷国至少提供1,000亿美元的气候相关融资的承诺也始终没有兑现。
Le monde doit réfléchir sérieusement à la manière de faire correspondre le financement multilatéral aux besoins multilatéraux.	世界必须认真地让多边资金与多变需要相匹配。
L'UE devrait rapidement doubler le budget de l'UE à 2% des revenus de l'UE, et plus au fil du temps.	欧盟应该迅速将欧盟预算提高到欧盟收入的2 % ， 并随着时间进一步增加。
De même, le monde devrait consacrer au moins 2% du revenu mondial aux biens et services publics mondiaux pour mettre fin à l'extrême pauvreté, lutter contre le changement climatique, protéger la nature, sauver des millions de personnes démunies de décès prématurés, assurer la scolarisation de tous les enfants et maintenir la paix par l'ONU.	类似地，世界应该至少将2%的世界收入用于全球公共品和服务以消除极端贫困，遏制气候变化，保护自然，拯救数百万赤贫者免于早亡，确保所有儿童有学可上，以及通过联合国保持和平。
Le temps est venu de penser à de nouvelles taxes mondiales – sur les revenus des multinationales, les comptes offshore, les transactions financières internationales, la richesse nette des milliardaires, la pollution – de manière à financer un monde interconnecté en péril.	应该考虑全球税收 — — 公司所得、离岸账户、国际金融交易、亿万富翁净财富、污染等 — — 来为承受压力的联动世界买单。
Avec de la créativité, de la coopération et de la prévoyance, nous pouvons mobiliser de nouveaux revenus pour transformer notre grande richesse mondiale en bien-être durable pour tous.	如果我们能拿出创造力、合作和远见，就能动员新收入，让巨大的全球财富转变为可持续的全民福利。
	
Les vulnérabilités du système financier	全球金融体系健康状况如何？
LONDRES – Depuis quelques semaines, des deux cotés de l'Atlantique les dirigeants politiques affirment que le système financier est équilibré et stable.	伦敦—最近几周以来，大西洋两岸的决策者纷纷重申金融系统可靠而稳定。
La Réserve fédérale américaine (Fed) a annoncé en juin que toutes les banques américaines ont réussi leur test de stress annuel.	美联储在6月份宣布，所有美国银行都通过了其最新的年度压力测试。
Et la présidente de la Fed, Janet Yellen, pense que la prochaine crise financière n'est pas pour demain.	美联储主席耶伦现在认为 ， “ 我们这辈子”都不会遭遇新的金融危机了。
Quant au Conseil de stabilité financière (FSB, Financial Stability Board) - qui veille à ce que les régulations financières à travers le monde respectent les normes internationales - il a écrit dans une lettre adressée aux dirigeants du G20 que les "formes toxiques des banques du secteur financier non régulé" sont en train d'être éliminées.	与此同时，负责监督全球监管措施，确保它们符合全球一致的标准的金融稳定委员会（FSB）在一封致G20领导人的信中宣布 ， “ 有毒害的影子银行”正在被清理。
Autrement dit, les mesures prises pour renforcer le système financier international ont incontestablement une certaine efficacité, notamment en ce qui concerne le renforcement des réserves en capitaux et le redressement du bilan de parties importantes du système bancaire.	简言之，支持全球金体系的持续努力显然收到了成效，特别是在增强资本缓冲和清理银行系统的最重要部分的资产负债表方面。
Les dernières garanties apportées par les dirigeants politiques rassurent ceux d'entre nous qui estiment que les mesures destinées à réduire le risque financier systémique sont insuffisantes et qu'il en est de même de celles consacrées à mettre les banques véritablement au service de l'économie réelle et à éviter qu'elles ne constituent une menace pour cette dernière.	决策者最近的信誓旦旦，与我们这些担心降低系统性金融风险，以及确保银行服务于实体经济而不是威胁实体经济福祉的措施做得仍然不够的人，形成了冲突。
Mais il est trop tôt pour affirmer que le systéme financier dans son ensemble est sain.	但现在就认定金融体系已经身体无恙为时过早。
Dans certains pays européens, les mesures destinées à consolider le secteur bancaire sont encore très insuffisantes.	在欧洲的一些国家，巩固银行部门的措施仍然远远落后于现实。
Et surtout les risques financiers continuent à migrer vers les secteurs non-bancaires.	更重要的是，金融风险仍然在向非银行活动蔓延。
Après les prises de risque irresponsables qui ont failli faire basculer l'économie mondiale dans une longue dépression en 2007-2008, les régulateurs et les banques centrales des pays avancés ont consacré beaucoup d'énergie à renforcer leur systéme financier et ils se sont intéressés en premier lieu au secteur bancaire.	在不负责任的冒险行为几乎让全球经济在2007—2008年陷入一场多年的萧条后，发达经济体的监管者和央行采取了大手笔强化金融体系。
De ce fait, les banques ont renforcé leurs réserves en capitaux propres, redressé leur bilan, accru leur liquidité, amélioré leur transparence, limité les opérations à haut risque et revu leurs incitations à la spéculation de manière à décourager les conduites irresponsables.	它们的措施，一开始的重点是银行，从那时开始，银行增强了用于吸收风险的资本缓冲，清理了混乱的资产负债表，增加了流动性，加强了透明度，减少了高风险活动，并在一定程度上梳理了内部激励，不再鼓励鲁莽行为。
Et le processus d'intervention auprès des banques en difficulté ou en faillite a été amélioré.	此外，清算快破产和破产银行的程序也有所改进。
Les dirigeants politiques ont non seulement renforcé le secteur bancaire, mais normalisé le marché des produits dérivés, amélioré sa transparence et sa solidité, ce qui évitera dans l'avenir aux contribuables de financer des plans de secours en faveur des institutions irresponsables.	除了强化银行部门，决策者还在衍生品市场标准化、使其变得更加稳健和透明方面取得了不少进展，这也降低了未来纳税人援助不负责任的机构的风险。
Par ailleurs le systéme de règlement a été rendu plus sûr, ce qui diminue le risque d'un arrêt brutal de l'activité économique - comme celui qui s'est produit fin 2008.	此外，支付和结算系统也变得更加安全，从而降低了经济活动“突然停止”的危险，比如2008年第四季度所发生的情况。
Il est encourageant de voir les autorités nationales coordonner leurs politiques sous les auspices du FSB.	国家监管当局在FSB的协调下进行合作，这样的局面让人感到鼓舞。
Cela réduit les risques d'un arbitrage entre réglementations, et celui que les banques soient "internationales durant leur vie, mais nationales au moment de mourir", selon la fameuse formule de Mervyn King, ancien gouverneur de la Banque d'Angleterre.	更好的协调降低了监管套利的风险，也解决了银行变得如英格兰银行前行长默文·金（Mervyn King）的名言所说的那样“生是国际的，死是国家的”这一问题。
Les USA et le Royaume-Uni ont été les premiers à engager des réformes, suivis par l'Europe.	美国和英国是改革的领导者，欧洲则一直在追赶。
Si elle se traduit dans la réalité, la garantie donnée par Yellen de parvenir à un système bancaire américain "beaucoup plus fort" s'appliquera à toutes les autres autorités bancaires d'importance systémique du monde développé.	假设确是如此 — — 许多这些地区的决策者都倾向如此 — — 耶伦对美国银行系统“大大增强”的担保也将适用于发达世界的其他所有具系统重要性的银行管理辖区。
Et la déclaration pleine d'assurance du FSB selon laquelle "les réformes ont corrigé les failles à l'origine de la crise financière mondiale" sera beaucoup mieux accueillie.	FSB的信心宣言 — — “改革解决了导致全球金融危机的断层线”也将受到更多的支持。
Mais il est trop tôt pour déclarer victoire.	但是，现在宣布胜利为时尚早。
Bien que le FSB considère maintenant que le système financier est "plus sûr, plus simple et plus équitable", il reconnaît l'apparition de "risques qui, si l'on n'intervient pas, pourraient s'opposer à l'objectif du G20 de parvenir à une croissance forte, durable et équilibrée".	尽管FSB说金融系统变得“更加安全、更加简单、更加公平 ” ， 但也承认“新萌发的风险，如果不加以制约的话，可能不利于G20的强劲、可持续和均衡的增长的目标 。 ”
En tant qu'observateur et participant des marchés financiers internationaux, je note trois risques principaux :	作为一名观察者兼国际资本市场的参与者，我看到了三大新萌发的风险。
1) Les banques les mieux régulés ayant mis fin (volontairement ou pas) à certaines de leurs activités, elles ont été remplacées par des sociétés qui ne sont pas soumises aux mêmes normes en matière de régulation et de supervision.	首先，随着较谨慎地监管的银行出于主动或其他原因停止了某些行为，它们现在已经被非银行机构取代，而这些非银行机构不受同样的监督和监管标准约束。
2) Des segments entiers de ces sociétés sont confrontés à une "illusion de liquidité", une partie de leurs produits pouvant susciter une attente illusoire quant aux liquidités qu'ils pourraient rapporter à des clients se livrant à des transactions dans certains domaines (obligations de sociétés à haut rendement ou obligations de sociétés des pays émergents) particulièrement vulnérables à la volatilité des marchés.	其次，非银行系统的某些部门现在有一种“流动性错觉 ” ， 即一些产品有可能对它们能够提供给某些业务领域的客户的流动性过于乐观 — — 比如高收益和新兴市场公司债券 — — 这些业务领域的流动性非常容易受到市场波动的影响。
Parallèlement, les fonds côté en Bourse prolifèrent, tandis que les intermédiaires financiers sont de moins en moins nombreux en comparaison des clients en bout de chaîne, plus importants et plus sophistiqués.	与此同时，交易所交易基金开始大量出现，而金融中介相对更大、更复杂的终端用户变得更加渺小了。
3) Le système financier n'a pas encore été percuté par l'ensemble des ruptures technologiques liées aux avancées technologiques (dans le domaine des grandes bases de données, de l'intelligence artificielle et de la mobilité) qui bouleversent un nombre croissant de secteurs économiques.	第三，金融体系尚未充分感受到大数据、人工智能和移动化等方面的进步所带来的技术性破坏的影响。 这些方面的进步已经颠覆越来越多的其他老牌行业。
Et la technologie financière (Fintech) dont le rayon d'action augmente alors qu'elle est mal régulée, n'a pas encore passé le test d'un cycle complet du marché.	不断扩大的金融技术活动得不到充分的监管，也没有经受过完整的市场周期的考验。
Ce n'est très probablement pas le secteur bancaire qui va être à l'origine d'une nouvelle crise financière mondiale, dangereuse pour la croissance et la prospérité.	平心而论，威胁到全世界的增长和经济繁荣的新的系统性金融危机，可能不会源于银行系统。
Mais il est trop tôt pour affirmer que le danger est derrière nous.	但就此断定我们已经摆脱了所有金融体系所面临的风险仍然过于鲁莽。
Du fait de la transformation des risques et de leur migration hors du secteur bancaire, les régulateurs et les responsables politiques devront intensifier leurs efforts et élargir la surveillance au-delà du secteur bancaire.	风险已经改变 — — 并且已经从银行系统转移出去 — — 因此监管者和监督者必须采取行动，将注意力扩大到银行之外。
Ainsi que l'a souligné Greg Ip dans le Wall Street Journal en 2015, pousser le risque hors de l'économie revient à appuyer sur une excroissance sur une chambre à air, elle réapparaît souvent à un autre endroit.	毕竟 ， 《 华尔街日报》的叶伟平（Greg Ip）在2015年时指出 ， “ 将风险挤出经济就像是挤压水床：风险通常会在别处重新出现。
Et de conclure : "Il en est de même avec les mesures destinées à rendre le système financier plus sûr depuis la crise financière".	金融危机以来为了让金融体系变得更安全的措施也是如此 。 ”
	
Une solution efficace et peu coûteuse au réchauffement planétaire	解决全球变暖的便宜之计
COPENHAGUE – Avec le réchauffement planétaire, les victimes de la chaleur seront de plus en plus nombreuses.	发自哥本哈根 — — 全球变暖对于我们来说，意味着将有更多人将死于高温。
On verra le niveau des eaux monter, et le paludisme, la famine et la pauvreté gagner du terrain.	海平面将升高，世界上将有更多人罹患疟疾并受到饥饿与贫困的威胁。
Les inquiétudes sont grandes, pourtant, l’humanité fait peu pour lutter réellement contre ces fléaux.	而尽管这些问题已经得到了足够的关注，但人类目前为切实阻止上述后果所做的一切都还只是九牛一毛。
Malgré maintes promesses de réduction des émissions de carbone, ces dernières ne cessent d’augmenter.	尽管人们一再承诺减排，但温室气体的排放量却仍然持续上升，
Il est de notre intérêt à tous de freiner le changement climatique.	事实上，确保气候不再肆意变化是和我们每个人都利益攸关的事情。
Nous avons fait appel aux spécialistes du climat pour qu’ils nous informent sur le problème du réchauffement planétaire.	在过去，我们求助于气象学家来了解全球变暖问题。
Maintenant, nous devons faire appel aux économistes du climat pour qu’ils nous éclairent sur les bénéfices, les coûts et les résultats éventuels des différentes solutions à ce problème.	而如今人们则需要求助于气候经济学家来指点一下那些针对全球变暖的不同应对措施所可能带来的效益，成本以及可能引起的后果。
Les leaders de la planète se rencontreront en décembre prochain à Copenhague pour mettre au point un nouveau pacte de lutte contre le réchauffement climatique.	来自世界各国领导人定于今年12月在哥本哈根会面，以共同缔结一个新的条约来应对全球变暖问题。
Devront-ils poursuivre les plans fondés sur des promesses de réduction des émissions de carbone qui ne seront probablement pas tenues ?	那么政要们是否应该坚持原来的承诺，继续坚持推动不太可能实现的碳排放削减计划？
Devront-ils plutôt retarder les réductions d’une vingtaine d’années ?	还是将减排计划向后推迟20年？
Que peut-on obtenir en plantant plus d’arbres, en limitant le méthane ou en réduisant les émissions de suie ?	如果我们种更多的树、减少沼气或降低煤炭排放能取得什么样的效果？
Est-il raisonnable de se concentrer sur une solution technologique au réchauffement ?	而把解决全球变暖的全部精力都放在一个技术解决方案上又是否明智？
Ou devrions-nous simplement nous adapter à un monde plus chaud ?	又或者我们要做的，只是适应一个更暖和的地球就好了？
Aujourd’hui, le débat politique reste principalement axé sur la réduction des émissions de carbone, alors qu’il existe une multitude d’autres façons d’améliorer le climat planétaire.	当今的大多数政策讨论依然将重点放在削减碳排放上，但解决全球气候问题其实是有许多道路可走的。
Nos choix auront des résultats et des coûts différents.	而我们的不同选择，将会导致不同的成果，付出的成本也会不同。
La combinaison optimale de remèdes sera celle qui aura l’impact le plus important à moindre coût.	而解决方案的最佳组合将能在耗费最少资金的同时产生最大的效益。
L’article novateur des économistes Eric Bickel et Lee Lane présente l’une des premières études, et certainement la plus complète, sur les coûts et les bénéfices de l’ingénierie du climat.	如今由经济学家埃里克·比凯尔和李·雷恩所发表的开创性论文则是最早 — — 当然也是最全面的 — — 研究气候工程学成本与收益的成果之一。
Manipuler le climat planétaire semble appartenir à la science-fiction, il faut pourtant s’y intéresser, comme l’a déclaré John Holdren, conseiller scientifique du président Barack Obama. Et nombre d’éminents scientifiques partagent cet avis.	人为操控地球气候原本似乎只是科幻小说的情节，但正如同美国总统奥巴马的首席科学顾问约翰•霍尔德伦所说的 ， “ 这想法值得看看 ” ， 而他的这一看法也得到了许多著名科学家的赞同。
Bickel et Lane donnent des preuves indiscutables qu’un investissement très faible dans l’ingénierie du climat pourrait réduire les effets du réchauffement climatique autant que les milliers de milliards de dollars dépensés pour réduire les émissions de carbone.	比凯尔和雷恩提出了令人信服的证据：只需对气候工程进行微薄的投入也许就能够降低全球变暖效应，而相同效果如果要通过削减碳排放来实现的话，则起码要耗费数万亿美元资金。
L’ingénierie du climat a l’avantage de la rapidité.	气候工程的有一个优势，那就是见效快。
En effet, il existe un retard significatif entre les réductions de carbone et toute chute des températures – une réduction même de moitié des émissions mondiales d’ici le milieu du siècle serait à peine mesurable à la fin du siècle.	因为碳排放削减与气温降低之间的因果关系之间有显著的时间差 — — 即使在本世纪中期成功将全球的排放量减半，但人们可能到等到世纪末都难以衡量其减缓气候变暖的效果如何。
Il faudra aussi du temps pour que l’énergie verte soit bon marché et monnaie courante. Pensez que l’électrification de l’économie mondiale est toujours incomplète après plus d’un siècle d’efforts.	而绿色能源的廉价化和推广也将需要很长时间，要知道人类都努力了一个多世纪了，至今连全球经济电气化都未能实现呢。
De nombreuses méthodes d’ingénierie atmosphérique ont été proposées.	有关大气工程学的许多方案��已经被提了出来。
La gestion de la radiation solaire semble l’une des plus utiles.	而其中最有希望的则是太阳辐射管理装置。
Les gaz à effet de serre atmosphériques laissent passer la lumière du soleil mais absorbent la chaleur et en renvoient une partie vers la surface de la terre.	大气中的温室气体在允许阳光穿过的同时吸收热量，并将部分热量辐射至地表。
Sauf imprévu, des concentrations plus élevées réchaufferont la planète.	在其他条件相同的情况下，温室气体浓度越高，地球就越暖。
La gestion de la radiation solaire permettrait de renvoyer un peu de rayonnement solaire dans l’espace.	而太阳辐射管理装置则能够将少量太阳光线反射回宇宙空间。
Refléter ne serait-ce que 1 à 2 % du total de la lumière du soleil qui frappe la terre pourrait compenser autant de réchauffement que celui causé par le doublement des niveaux préindustriels de gaz à effet de serre.	只要把到达地表的太阳光线总量的1%至2%反射回去，所减少的热量就等于全球工业化之前地球温室气体所产生的总热量的两倍。
Au cours de l’éruption du mont Pinatubo en 1991, environ un million de tonnes de dioxyde de souffre a été projeté dans la stratosphère, provoquant une réaction avec l’eau et la formation d’une couche brumeuse qui s’est répandue sur tout le globe et – par dispersion et absorption de la lumière entrante du soleil – a refroidi la surface de la terre durant près de deux ans.	当皮纳图博火山在1991年喷发的时候，大约100万吨二氧化硫被排放到大气的同温层当中，随后与水汽共同作用，形成了一个雾状的气层并散布到整个地球 — — 这一气层散射和吸收了射进来的太阳光线 — — 致使地球表面温度降低长达两年之久。
Nous pourrions reproduire cet effet par l’apport d’aérosol stratosphérique, principalement en envoyant dans la stratosphère des éléments tels que du dioxyde de souffre ou de la suie.	而我们则可以通过在同温层注入悬浮粒气体来模拟这种效应 - - - - 实质上就是向同温层发射二氧化硫或煤灰等物质。
Autre méthode prometteuse, le blanchiment des nuages marins consiste à vaporiser des gouttelettes d’eau de mer vers les nuages pour les rendre plus réfléchissants.	而另一个可实现的方法是将增加海洋云的白化程度，即把雾状的海水微粒喷射入云中使其能反射更多的阳光。
Cela augmente le processus naturel au cours duquel le sel de mer fournit de la vapeur d’eau avec le noyau de condensation des nuages.	这实际上是加速了一种自然进程 — — 海洋中的盐分可以为水汽凝结成云的进程提供更多的凝结核。
Il est remarquable de penser qu’on pourrait annuler le réchauffement planétaire de ce siècle grâce 1 900 navires téléguidés qui vaporiseraient de l’eau de mer dans l’air pour épaissir les nuages.	想想看那种壮观的情景：用1900艘无人驾驶的大船，向空中喷射雾状的海水水汽使得云层加厚，就可以消灭本世纪全球变暖现象。
Le coût total serait d’environ 9 milliards de dollars et les bénéfices issus de la prévention de la hausse des températures, d’environ 20 000 milliards.	这项工程的总成本大约将是90亿美元，而阻止气温上升所带来的收益则可以达到20兆美元。
Cela revient à obtenir environ 2000 dollars pour chaque dollar dépensé.	这样做等同于每花1美元，就能得到2000美元的回报。
Une grande partie des risques de la géo-ingénierie ont été exagérés.	而与此同时，气候工程的许多风险则被人们过分夸大了。
Le blanchiment des nuages marins n’entraînerait pas de changements atmosphériques permanents et pourrait être utilisé uniquement en cas de besoin.	海洋云的白化效应将不会导致永久的大气变化，且只在需要时才会使用。
La transformation l’eau de mer en nuages est un processus naturel.	加上海水转化成云层本来就是一种自然过程。
La plus grande difficulté qui se pose est la perception du public.	而最大的挑战则来自于公众意识。
De nombreux lobbyistes de l’environnement s’opposent à la recherche même de l’ingénierie du climat – ce qui est surprenant au vu de ses multiples avantages.	许多环保政治说客甚至反对气候工程学的研究。 鉴于其多方面的益处，这样的反对实在令人费解。
Puisque les préoccupations portent avant tout sur la hausse des températures, on devrait donc se réjouir du fait que cette méthode simple et efficace par rapport à son coût soit aussi prometteuse.	如果我们主要关注的就是如何避免地球气温升高的话，就应对拥有这个如此简单、高性价比且前景如此清晰的方法感到兴高采烈才对。
L’ingénierie du climat pourrait rester une solution de dernier recours, en cas de besoin. Nous pourrions également l’inscrire aujourd’hui parmi nos priorités.	气候工程可以被当做一个后备选择以备不时之需，或者我们现在就可以立刻将它提上日程。
Dans l’un ou l’autre cas, il est impératif de la prendre au sérieux.	在两种可能性之下，目前的危机形势都需要我们对其进行严肃的考量。
Nous risquons d’être la génération qui a perdu des décennies à se chamailler au sujet de la réduction des émissions de carbone et qui n’a pas réussi à faire cesser les effets nuisibles du réchauffement.	因为我们正在沦落为这么一代人 — — 徒费几十年光景为了削减碳排放而争吵，却并没能阻止全球变暖所带来的有害效应。
Ce serait un fardeau honteux que l’on pourrait éviter en repensant la politique climatique.	而这将是一笔令人蒙羞的遗产 — — 只有重新思考气候政策，才能避免留下如此恶名。
	
Les victimes incomprises du réchauffement climatique	被误解的全球变暖受害者
BAMAKO, MALI – Les médias des pays riches envoient régulièrement leurs reporters à la recherche de « victimes du réchauffement climatique. » Leurs dépêches qui nous parviennent des îles du Pacifique, du Bengladesh ou d’Ethiopie nous annoncent l’imminence de la catastrophe.	发自巴马科，马里 — — 发达国家的媒体经常派人四处挖掘所谓的“全球变暖受害者 ” 。 这些记者们从太平洋岛国，孟加拉或埃塞俄比亚等地方发来的消息一再向我们警告说灾难正迫在眉睫。
Le réchauffement climatique représente le défi le plus terrible auquel sont confrontées ces régions. Il est vital de trouver une solution à ce problème.	他们声称，全球变暖成为了这些地区所面对的最严峻挑战，急需解决方案。
Ces personnes dont on nous dit qu’elles sont en danger sont pourtant rarement écoutées.	然而，我们很少听到那些据说正在受灾的当地人的说法。
Elles ne sont pas muettes, mais nous ne prêtons aucune attention à ce qu’elles disent.	但这些人可不是哑巴，只是我们不去关注而已。
Le Centre du Consensus de Copenhague a décidé de donner la parole à ces personnes vivant dans les zones particulièrement concernées par le réchauffement climatique afin qu’elles évoquent leurs craintes et leurs espoirs.	哥本哈根共识研究中心则派人去对那些生活在在全球变暖重灾区的人们所拥有的恐惧和希望进行研究。
A Mojo, au centre de l’Ethiopie, nos chercheurs ont rencontré Tadese Denkue, un ancien soldat de 68 ans sans revenus réguliers. « Je ne sais jamais quand je pourrais m’acheter de quoi manger » dit-il, « je sais juste que je souffre beaucoup.	在埃塞俄比亚中部城市莫角，我们的研究人员遇见了68岁的泰德西 · 邓库，他当过兵，现在没有稳定的收入。 在交谈中，他抱怨说“我不知道什么时候我才能养活自己。
Cette vie est indécente. »	我只知道我遭了很多罪，这不是什么好活法 。 ”
Tadese n’a jamais entendu parler du réchauffement climatique.	泰德西从来就没听说过全球变暖。
Lorsqu’on le lui explique, il semble bien peu concerné.	在我们向他解释完了之后，他显得不屑一顾。
Il a des soucis bien plus pressants. « La première chose dont j’ai besoin, c’est de nourriture, et puis d’un travail. »	的确，他有更多别的操心事需 ， “ 当下我最缺的就是吃的，然后就是一份活儿 。 ”
Tadese subit sa deuxième crise de paludisme cette année. Il ne se souvient même plus du nombre de crises qu’il a déjà eu.	现在他正在遭受着疟疾的折磨，这已经是今年的第二回了，他已经记不清楚与这种疾病打了多少回交道。
Notre chercheur l’accompagne au dispensaire. L’électricité est en panne.	我们的研究员陪同他去了一间免费诊所。
Le médecin admet que la plupart des patients sont renvoyés chez eux sans même faire l’objet d’un examen ou de traitement : le dispensaire n’a plus aucun médicament à distribuer.	但是诊所断了电，那里的一位医生坦率地告诉我们说，这边大部分的病人还没有得到检查或治疗就被送了回家。 但这也是没有办法，诊所的药品早就用光了。
La crainte du paludisme est l’argument utilisé pour justifier les réductions drastiques d’émissions de carbone.	疟疾肆虐的威胁曾作为要求大幅度削减碳排放的理由。
Un climat plus chaud, plus humide favorise le développement du parasite responsable du paludisme.	因为更温暖，潮湿的气候将有利于携带疟疾的蚊虫繁殖。
La plupart des estimations indiquent que le réchauffement climatique soumettra 3% supplémentaires de la population mondiale au risque du paludisme d’ici à 2100.	大多数评估报告认为到了2100年，全球变暖将使全球面临疟疾威胁的人口数量增加3 ％ 。
Les programmes de réduction d’émissions de carbone les plus efficaces, sensés limiter la hausse des températures à 2° Celsius maximum, devraient coûter 40 billions de dollars par an jusqu’en 2100, selon une enquête de Richard Tol pour le Centre du Consensus de Copenhague.	而据理查德·图尔为共识研究中心所做的研究，到2100年，全球最有效的碳减排计划 — — 旨在温度上升幅度控制在2摄氏度之内 — — 将每年耗费40万亿美元。
Dans le meilleur des scénarii, cette dépense ne réduirait le taux de population à risque que de 3 %.	但即便在最理想的状况下，这笔钱也只能减少3％的受灾人口。
Comparativement, dépenser 3 milliards par an en moustiquaires, en bombes insecticides d’intérieur sans danger pour l’environnement et en financements de nouvelles combinaisons thérapeutiques efficaces, pourrait réduire de moitié le nombre de personnes infectées en moins de dix ans.	相比之下，如果在未来十年内能每年拨出30亿美元来鼓励使用蚊帐和室内无害DDT喷雾，以及资助有效的新型综合疗法，就可以在10年内使疟疾受灾人口减半。
Pour une vie sauvée via la réduction des émissions polluantes, des politiques plus intelligentes en sauveraient 78 000.	同样的钱，花在碳减排上只能挽救一条生命，而花在更明智的政策上则能挽救7万8千条生命。
Le paludisme n’est évidemment pas la seule inquiétude liée au réchauffement climatique.	当然，我���关注全球变暖并不仅仅因为疟疾。
A 20 kilomètres de Mojo, notre chercheur a rencontré Desi Koricho et son fils de 18 mois, Michel.	在距离莫角20公里的地方，我们的研究员遇见了德茜·克里科赫和 她8个月大的儿子米歇尔。
Tous les quinze jours, Desi marche 4 heures durant pour emmener Michel au centre de santé.	每两个星期，德茜都要陪她的儿子长途跋涉4小时去健康中心。
Après deux mois d’un traitement contre la malnutrition, Michel a bien grandi mais n’a que la moitié de la taille habituelle d’un enfant de son âge.	经过两个月的营养不良治疗之后，米歇尔已经长大了很多，但他的身子仍然只有其同龄婴儿的一半大。
Michel n’est pas le fils biologique de Desi.	米歇尔并不是德茜的亲生子。
Elle l’a recueilli lorsqu’il a été abandonné par sa famille à la suite du suicide de son père.	在米歇尔的父亲自杀后，这位母亲就收养了这个被遗弃的孤儿。
Desi souffre probablement elle aussi de malnutrition, mais aucun diagnostic ne l’a confirmé.	但德茜自己也身患病因不明的营养不良疾病。
C’est assez courant par ici.	实际上，这种病在这个地方很普遍。
Il n’y a pas de routes, pas d’électricité, ni d’infrastructure d’aucune sorte.	没有道路，没有电，也没有其他什么公共设施，只有拥挤和肮脏。
Les conditions de vie sont très difficiles, sans aucune hygiène. « Nous avons besoin de tout » raconte Desi.	德西向我们倾诉“我们什么都缺 ” 。
Résoudre les problèmes de malnutrition serait un bon début.	而扫除疟疾将是解决该地区问题的一个较好的突破口。
Les militants en Europe et aux Etats-Unis utilisent la peur de la famine pour justifier les programmes de réduction drastique d’émissions de carbone.	欧洲和美国的示威者用饥荒的威胁来作为大规模削减碳排放的理由。
Pour la plupart des régions, les changements climatiques vont contribuer à une meilleure productivité agricole.	然而事实上，对大部分地区来讲，气候变化将提高农业生产力。
Ce n’est malheureusement pas le cas d’une grande partie de l’Afrique, déjà accablée par la famine.	但对已经饱受饥饿折磨的非洲地区来讲，气候变化带来的却是残酷的现实。
Mais, comme dans le cas du paludisme, tous les témoignages montrent que des actions directes sont bien plus efficaces que les réductions d’émissions polluantes.	但是，如同疟疾的例子一样，所有的证据都显示直接的治理政策比削减碳排放要有效得多。
Un des traitements efficaces, bien que sous-estimé, consiste à distribuer des micronutriments à ceux qui souffrent de carence nutritionnelle.	其中一种非常有效但却总被忽视的方法就是向有需要的人们提供微量营养素。
Le simple fait de donner de la vitamine A et du zinc à 80% des quelques 140 millions d’enfants souffrant de malnutrition nécessiterait un engagement d’à peine 60 millions de dollars par an.	每年只需花6000万美元就能向全球1亿4千万营养不良儿童中的80％提供足够的维他命A和锌。
Pour 286 millions de dollars, nous pourrions donner du fer et de l’iode à plus 2,5 milliards de personnes.	而只需花2亿8千6百万，我们便能给超过25亿人口提供铁和碘。
Le choix est difficile : pour quelques centaines de millions de dollars, nous pourrions aujourd’hui aider presque la moitié de l’humanité.	这简直是想都不用想的选择：只用区区的几亿美元，我们就能救助全球过半的人口。
Il faut comparer cela aux investissements consacrés au changement climatique, soit 40 billions de dollars par an d’ici à la fin du siècle qui sauveraient cent fois moins de personnes souffrant de famine (et en 90 ans !).	这样的投资与解决气候变化的成本相比 — — 每年需耗费40万亿美元直到本世纪末 — — 同样一笔钱则可以在未来90年内把那些挣扎于饥饿线上的人们拯救近百次。
Pour chaque vie sauvée de la malnutrition par le biais des politiques climatiques, les mêmes montants financiers dirigés vers les politiques directes sauveraient un demi million de personnes grâce aux micronutriments.	都是那么多钱，花在气候政策上只能够使一个人摆脱营养不良，而用在更直接有效的政策上却能使50多万人口免于遭受微量营养素不足的折磨。
Certains estiment qu’il n’est pas juste d’opposer les programmes de réduction d’émissions de carbone aux politiques directes.	不过，有人认为对减少碳排放和直接政策两者所耗费的成本作比较是不合理的。
Mais il est indiscutable qu’aucun dollar ne peut être dépensé deux fois.	但我们不能忽视一个基本的事实：一笔钱只能用在一个地方。
Les pays riches et les donateurs ont réduit les budgets et l’ampleur des interventions.	发达国家和富裕的捐献者的预算和精力都是有限的。
Si nous destinons d’importantes sommes d’argent à la réduction des émissions de carbone, convaincus, même à tort, que nous éradiqueront le paludisme et que nous réduiront la malnutrition, il est fort probable que nous serons peu disposés à provisionner les sommes nécessaires au soutien des politiques directes qui seraient utiles aujourd’hui.	如果我们被那些错误的信念牵着鼻子走，自以为在对抗疟疾和减少营养不良而把大量的资金花在削减碳排放上，那么当然也拿不出什么钱投放到那些效果立竿见影的直接性政策上了。
Car pour chaque dollar dépensé sur des politiques climatiques fortes, nous ne contribuerons que 0,02 dollar pour le bien de notre avenir.	而事实上，我们扔在强力气候控制政策上的每1个美元，在未来大概只能收到相当于0.02美元的回报。
Si nous dépensons le même dollar sur des politiques simples de prévention de la malnutrition et du paludisme, et en prenant en considération tous les impacts, nous contribuerions 20 dollars ou plus, soit 1000 fois mieux.	相反，如果现在我们把同样的钱投到直接有效的政策来治疗营养不良和根除疟疾，那么我们将收获20美元甚至更多。 而即便把所有的影响因素都考虑进来，也比花在气候控制政策上的收益要高1000倍。
Sur le Mont Kilimandjaro en Tanzanie, où les effets du réchauffement climatique sont déjà visibles, notre chercheur a rencontré une jeune femme de 28 ans, Rehema Ibrahim.	在位于坦桑尼亚的乞力马扎罗山区 — — 在那里我们可以清晰地感受到全球变暖的影响 — — 研究员遇见了雷赫玛·伊布拉希姆。
Rehema a été répudiée par son mari et reniée par sa famille pour ne pas avoir pu leur donner un enfant.	由于怀不上孩子，她在被丈夫休掉后又被娘家人赶了出来。
Elle a alors commencer à dormir avec d’autres hommes pour savoir si elle était vraiment stérile.	而为了弄明白究竟不育是不是她自身的原因，雷赫玛又跟许多男人发生了关系。
Elle est maintenant séropositive, paria d’une société terriblement pauvre.	到如今她成了一个在极度贫穷的社会里身患艾滋病的边缘人。
Rehema a remarqué les changements de climat.	但雷赫玛却注意到了气候的变化。
Elle constate que la neige et la glace ont fondu.	她说山上的冰雪都在融化，所以她能够理解我们所说的“全球变暖 ” 。
Elle sait ce que signifie « réchauffement climatique. » Mais elle dit : « Mes problèmes sont prioritaires.	但她对我们说 ： “ 我自己的问题更要紧。
Le HIV et les soucis qu’il provoque sont bien plus importants que la [fonte de la] glace. »	我身上的艾滋病毒及其引起的并发症可比冰川萎缩问题严重多了 。 ”
Les partisans des réductions d’émissions de carbone s’intéressent beaucoup au phénomène de fonte des glaces et des neiges du Kilimandjaro.	呼吁削减碳排放的示威者通常都会强调乞力马扎罗山上区冰雪的融化。
Mais il faut aussi nous intéresser aux personnes qui vivent dans l’ombre de la montagne.	但实际上，更需要我们关注的，其实就是这些生活在山脚下的人们。
	
Les OMG et la science au rabais	转基因生物和垃圾科学
STANFORD – Dans le paysage médiatique d'aujourd'hui, où les opinions non fondées, le battage et les rumeurs vont bon train, la méthode scientifique (les moyens par lesquels nous déterminons, en fonction de preuves empiriques et mesurables, ce qui est vrai), doit servir de pierre de touche de la réalité.	斯坦福—在今天的媒体上，子虚乌有的观点、天花乱坠的宣传和流言层出不穷，科学方法 — — 我们根据实证和可测的证据确定什么是真的手段 — — 应该成为现实性的试金石。
La science nous permet de mesurer l'étendue de nos connaissances et d'identifier ce que nous ne savons pas.	科学让我们能够评估我们认为我们知道的，认识我们所不知道的。
Plus important encore, elle jette le discrédit sur les fausses affirmations faites pour des raisons personnelles ou politiques, ou du moins elle se doit de le faire.	最重要的是，科学质疑出于个人和政治原因而提出的错误主张 — — 至少应该如此。
Mais parfois quelques scientifiques « passent de l'autre côté » et délaissent la méthode scientifique (souvent pour des questions de notoriété ou de profit économique), pour produire de la propagande et semer la peur au sein de l'opinion publique qui ne dispose pas de compétences mais est toujours friande d'informations.	科学家偶尔也会“流氓化 ” ， 放弃科学方法 — — 常常引来臭名或为了追求经济利益 — — 炮制宣传，在缺少专业知识又渴望知情的公众中间散播恐慌。
Cet abus de l'autorité scientifique est particulièrement répandu dans les secteurs des aliments « biologiques » et « naturels », qui tirent profit de la peur éprouvée à l'égard des produits synthétiques ou « non naturels ».	这一对科学权威性的滥用在“有机”和“自然”食品行业尤其普遍，这些行业利用人们对合成或“非自然”产品的恐慌心理。
Un exemple récent est celui du scientifique américain d'origine hindoue V.A. Shiva Ayyadurai, qui, avec Prabhakar Deonikar, a publié cet article que tout le monde a tourné en dérision : « Les OGM accumulent-ils le formaldéhyde et perturbent-ils les équilibres des systèmes moléculaires ?	最近的例子是印度裔美国科学家阿亚杜拉伊（V.A. Shiva Ayyadurai ） ， 他和德奥尼卡尔（Prabhakar Deonikar）发表了一篇非常可笑的文章《转基因生物会积累甲醛、干扰分子系统均衡吗？ 系统生物学可以提供答案 》 。
La biologie des systèmes a peut-être certaines réponses. » (Les « OGM » sont des « organismes génétiquement modifiés », une catégorie en elle-même trompeuse et souvent injustement stigmatisée, qui englobe un univers d'organismes modifiés par les techniques plus modernes et les plus précises du génie génétique.)	（ “ 转基因生物”本身就是一个误导性的、常常受到莫名指责的非分类（non-category ） ， 包括各种用最现代、最精确的遗传工程技术改良的生物。 ）
Bien que l'article soit apparemment passé par le processus d'examen par les pairs, un élément clé de la science légitime, il est paru dans un journal à articles payants à faible impact, Agricultural Sciences, produit par un éditeur « agressif ».	尽管这篇文章必然是经过了同行评议流程的（同行评议是合理科学的一个关键要素 ） ， 但发表它的是一份影响力很低的“收费刊登”期刊《农业科学 》 （ Agricultural Sciences ） ， 有一家“掠夺性”出版商发行。
Dans les jours qui ont suivi sa publication, des organisations anti-biotechnologies comme Organic Consumers Association et OGM Inside ont publié des articles à partir des « découvertes » d'Ayyadurai, assortis de titres effrayants : « Du formaldéhyde dans le soja OGM ? » et « Une nouvelle étude montre que le soja OGM accumule le formaldéhyde qui cause le cancer », accompagnés de graphiques effrayants.	这篇文章发表不出几天，反生物技术组织，如有机消费者协会（Organic Consumers Association）和转基因生��内幕（GMO Inside）等，纷纷以耸人听闻的标题报道阿亚杜拉伊的“发现 ” — — 《 转基因大豆含有甲醛？ 》 、 《新研究表明转基因大豆累积致癌化学物质甲醛 》 — —并配以吓人的图片。
Mais l'article d'Ayyadurai comporte une foule de problèmes.	但阿亚杜拉伊的文章可谓漏洞百出。
Son titre à lui seul suffit à montrer que quelque chose ne va pas.	光看标题就足以表明大有问题。
Si l'on estime que les OGM pourraient bien « accumuler le formaldéhyde », un produit chimique qui est probablement cancérigène à des niveaux élevés, mais est présent dans la plupart des cellules vivantes et que l'on trouve en abondance dans notre environnement, la réponse évidente consiste alors à mesurer ses niveaux dans les organismes.	如果你认为转基因生物可能“累积甲醛 ” — —高量甲醛可能致癌，但活性最好的细胞也含有甲醛，并且它可以在环境中广泛找到 — — 那么显而易见的反应应该是测量它在这种生物体中的量。
En revanche, Ayyadurai a choisi de faire des estimations fondées sur la modélisation à partir de la « biologie des systèmes. »	但阿亚杜拉伊却选择了基于通过“系统生物学”的建模进行猜测。
La « biologie de systèmes » permet seulement de faire une prévision, pas de tirer une conclusion expérimentale.	“系统生物学”只能形成预测，而不能形成实验推论。
Plutôt que de réellement examiner les niveaux de tous les produits chimiques dans les usines, Ayyadurai a rentré les données dans un algorithme d'ordinateur pour prévoir les niveaux de deux produits chimiques, le formaldéhyde et le glutathion.	阿亚杜拉伊并没有实际检测作物中的任何一种化学物质含量，而是将数据输入一套计算机算法，预测两种化学物质 — — 甲醛和谷胱甘肽的含量。
On peut comparer cela à un météorologue qui prédirait en fonction de ses modèles qu'il fera beau toute la journée, au lieu de regarder par la fenêtre et de voir que la pluie tombe.	这就好比是气象学家根据模型预测全天晴朗，而不屑朝窗外看一眼是否在下雨。
Comme l'a expliqué Kevin Folta, Directeur du département des sciences horticoles à l'Université de la Floride, la biologie des systèmes peut être une approche utile, quand on l'utilise correctement.	诚然，佛罗里达大学园艺系主任富尔塔（Kevin Folta）解释说，如果使用得当，系统生物学可以是有用的方法。
Selon ses termes, la biologie de systèmes « est une manière de faire des prévisions en intégrant des données existantes, puis en en dérivant une probabilité statistique que les prévisions peuvent être correctes. » Mais il insiste sur ce fait que les prévisions doivent alors être examinées « et que l'approche par les systèmes doit être validée. »	他说，系统生物学“是一个基于整合已有数据产生预测，然后通过统计方法确定预测正确概率的方法 。 ” 但是，他强调，预测必须得到检验 ， “ 并且系统方法必须可行 。 ”
Comme toutes les études prédictives basées sur la modélisation informatique, la validité des résultats dépend de l'intégrité des données et de l'algorithme.	和所有基于计算机建模的预测研究一样，结果的可靠性取决于数据和算法的完整性。
Si les données sont sélectionnées en vue d'étayer les conclusions désirées par celui qui opère la modélisation, ou si l'algorithme est défectueux, les résultats seront alors imprécis.	如果数据经过挑选以支持建模者想要的推论，或者如果算法有缺陷呢，那么结果就不准确。
Mais l'article d'Ayyadurai ne cite pas précisément les données qu'il a utilisées et il n'y a pas eu de validation du modèle.	但从阿亚杜拉伊的文章中难以清楚他使用了什么数据，因此他的模型是无效的。
	富尔塔巧妙地讽刺了阿亚杜拉伊的工作。
Folta tourne brillamment en ridicule le travail d'Ayyadurai. « Si vous développez un programme informatique qui intègre des données Internet, afin de prévoir l'emplacement de Munich et que le programme vous répond carrément que cette ville se trouve dans le Golfe du Mexique, à côté de la Floride, cela ne signifie pas que Munich se trouve dans le golfe du Mexique, à côté de la Floride. » Cela signifie plutôt que vous avez fait une erreur dans votre programme, dans vos hypothèses ou dans la saisie des données, autant de choses qui sont vérifiables.	“如果你开发了一套计算机程序，用它整合互联网数据来预测慕尼黑的位置，而程序告诉你它大概是在墨西哥湾，紧邻佛罗里达州，这并不意味着慕尼黑就在墨西哥湾，紧邻佛罗里达州 。 ” 相反，这意味着你在你的程序、假设或输入数据中犯了一个错误 — — 所有这些都是可检验的。
Folta explique ensuite, que décider de ne pas contester ces données et au lieu de cela de « publier une carte qui montre que Munich est carrément dans le Golfe du Mexique, en s'opposant à toutes autres données et aux déclarations quelque peu ironiques de millions d'Allemands, ne signifie pas que vous êtes brillant.	如果你选择不挑战这些数据，富尔塔继续说，而是“发布一份地图，标明慕尼黑位于墨西哥湾，一反其他数据和德国人的主张，这并不意味着你了不起。
Cela signifie que vous n'avez absolument aucune idée sur la question, ou plutôt que vous devez avoir une bonne raison de vouloir qu'une grande métropole allemande se trouve à deux heures de bateau de Tampa. »	这意味着你根本不了解情况，或者更有可能你出于某些理由希望德国大都市位于距离坦帕（Tampa）两小时船程的地方 。 ”
Folta a aussi quelque chose à dire au sujet de l'éditeur d'Ayyadurai.	富尔塔对阿亚杜拉伊的发行商也有话要说。
Si vous imprimez la carte mensongère indiquant l'emplacement de Munich, « qu'est-ce que cela nous révèle sur votre intégrité au titre de source d'information fiable ? »	如果你印制标明慕尼黑位置的假地图 ， “ 那这对你作为可靠信息源的诚信意味着什么 ？ ”
Dans un esprit de coopération scientifique, Folta a proposé de collaborer avec Ayyadurai sur les tests universitaires portant sur les échantillons de maïs et de soja génétiquement modifiés (et de fournir des contrôles appropriés), grâce aux analyses d'un laboratoire indépendant.	根据科学合作的精神，富尔塔提出与阿亚杜拉伊合作进行基于大学的转基因玉米和大豆样本（以及合适的控制组）检测，并由独立实验室进行分析。
Ayyadurai ayant décliné cette proposition, Folta effectuera donc lui-même ces examens.	阿亚杜拉伊拒绝了，因此富尔塔将靠自己进行检测。
Les données expérimentales seront bientôt publiées.	实验数据即将产生。
En attendant, si vous rêvez de manger des Sauerbraten et des Spaetzle, dirigez-vous donc vers l'Europe centrale, pas vers le Golfe du Mexique.	与此同时，如果你想吃德国醋焖牛肉和德国面疙瘩，你得去中欧而不是墨西哥湾。
	
Une morale sans dieu	无神的道德
La religion est-elle indispensable au sens moral ?	宗教对道德而言是必要的吗？
Nombreux sont ceux qui considèrent qu'il est scandaleux, voire blasphématoire, de nier l'origine divine de la moralité.	许多人认为，否定道德的神源是无法容忍、甚至是亵渎神灵的。
Soit un être divin a façonné notre sens moral, soit nous en avons hérité grâce aux enseignements d'une religion organisée.	要么某些神灵创造了我们的道德感，要么我们从有组织的宗教教诲那里得到了道德感。
Dans les deux cas, la religion nous est nécessaire pour contenir les vices de la nature.	无论哪种方式，我们都需要宗教来约束天性的邪恶。
Pour paraphraser Katherine Hepburn dans le film African Queen, en nous donnant une boussole morale la religion nous permet de nous hisser au-dessus de cette vilaine vieille Mère nature.	正如Katherine Hepburn在电影“非洲皇后”中所说的那样，宗教让我们摆脱邪恶的自然天性，给了我们道德指南针。
Pourtant la notion que le sens moral nous vient de Dieu soulève de nombreux problèmes.	但是，道德来自上帝的观点有重重问题。
L'un d'entre eux est que nous ne pouvons pas, sans sombrer dans la tautologie, affirmer simultanément que Dieu est bon et qu'il nous a donné le sens du bien et du mal.	一个问题是，我们无法在不陷入同义反复的情况下同时说上帝是好的，而且上帝给了我们善恶感。
Car alors nous sommes simplement en train de dire que Dieu répond à ses propres critères.	因为这样，我们就是在说上帝符合上帝的标准。
Un deuxième problème est qu'il n'existe pas de principe moral qui soit partagé par tous les peuples religieux, sans considération de leurs croyances spécifiques, mais pas par les agnostiques ou les athées.	第二个问题是，除了不可知论者和无神论者认同的道德准则之外，并不存在所有信神的人都认同的道德准则，而无论他们具体信仰。
En effet, les athées et les agnostiques ne se conduisent pas moins moralement que les croyants, même si leurs bonnes actions reposent sur des principes différents.	事实上，无神论者和不可知论者行为做事的道德水准并不比宗教信仰者要低，即使他们的善举建立在不同原则的基础之上。
Les non-croyants possèdent souvent un sens du bien et du mal aussi solide que les autres, ils ont lutté pour l'abolition de l'esclavage et contribué à d'autres mouvements visant à soulager la souffrance humaine.	不信仰者经常与任何人一样具有同样强烈和坚实的善恶感，而且还致力于废除奴隶制度并为其他减轻人类痛苦的事业贡献力量。
Le contraire est aussi vrai.	相反也是一样。
La religion a conduit les humains à commettre une longue litanie de crimes odieux, de l'ordre de Dieu donné à Moïse de massacrer les Madianites, hommes, femmes, garçons et filles non vierges, aux croisades, à l'Inquisition en passant par les innombrables conflits entre musulmans sunnites et chiites, jusqu'aux kamikazes convaincus que leur martyr les mènera droit au paradis.	宗教让人们犯下了大量可怕的罪行。 它们包括上帝的旨意让摩西屠杀米甸人，不论男女老少以及失去贞操的女孩、十字军东征、宗教裁判所、逊尼派和什叶派穆斯林之间无以计数的冲突以及那些相信殉教会让他们升入天堂的人肉炸弹。
La troisième difficulté qu'affronte le point de vue selon lequel le sens moral est enraciné dans la religion est que certains éléments de moralité semblent universels, malgré des différences doctrinales marquées parmi les principales religions du monde.	道德植根于宗教的第三个问题是，尽管世界主要宗教间的教义差异巨大，道德的某些成分看起来是普世的。
En fait, ces éléments s'étendent même à des cultures comme celle de la Chine, où la religion prend moins d'importance que des conceptions philosophiques comme le confucianisme.	在中国，与儒家学说等哲学观念相比，宗教要逊色一筹。 实际上，这些成分也甚至延伸到像中国那样的文化之中。
Il se peut qu'un créateur divin nous ait donné ces éléments universels au moment de la création.	可能是某个神圣的造物主在创世之时就把普世成份交给了我们。
Mais une explication alternative, en accord avec les faits de la biologie et de la géologie, est que durant des millions d'années nous avons développé une faculté morale qui génère des intuitions sur ce qui est bien et ce qui est mal.	然而，另一个符合生物学和地质学事实的替代解释是，在数百万年中，我们已经演进了一种可以产生有关对错的直觉的道德能力。
Pour la première fois, la recherche dans le domaine des sciences cognitives se basant sur des arguments théoriques émergeant d'une philosophie morale a permis de résoudre la vieille dispute sur l'origine et la nature de la moralité.	认知科学研究第一次在道德哲学引发而来的理论观点基础之上使得解决有关道德起源和性质等古老的争论成为可能。
Considérons les trois scénarios suivants.	考虑以下三个情形。
Pour chacun, remplacez le blanc par “obligatoire,” “acceptable” ou “interdit.”	对于每个情形，在空白处填上“有义务 ” 、 “可以”或者“禁止 ” 。
1.	1.
Un wagon fou est sur le point de renverser cinq personnes marchant sur la voie.	一个失控的货车车厢就要撞到正在轨道上行走的五个人了。
Un cheminot se tient près d'un interrupteur qui peut faire dévier le wagon sur une autre voie, tuant une personne, mais permettant aux cinq autres de rester en vie.	一个铁路工人站在道岔转换旁边。 那个道岔转换可以把车厢转到岔道上，撞死一个人，但是可以让五个人活下来。
Appuyer sur l'interrupteur est ______.	扳道岔是 _ _ _ _ _ _ 。
2.	2.
Vous passez à côté d'une fillette en train de se noyer dans une mare peu profonde, et il n'y a personne d'autre aux environs.	有一个小孩就要在浅池塘里被淹死，你正好路过而且是唯一在场的人。
Si vous prenez l'enfant, elle sera sauvée et votre pantalon sera fichu.	如果你抱起孩子，她就会活下来，但是你的裤子就损坏了。
Prendre l'enfant est _______.	抱起孩子是 _ _ _ _ _ _ 。
3.	3.
Cinq personne viennent d'arriver à l'hôpital dans un état critique, et tous ont besoin d'une greffe d'organe pour survivre.	五个重症病人被急送到医院，每人都需要一个器官才能活命。
Le temps manque pour récupérer des organes hors de l'hôpital, mais il y a une personne en bonne santé dans la salle d'attente.	没有时间从医院外面取器官，但是医院的等候室里有一个健康的人。
Si le chirurgien prélève les organes de cette personne, elle mourra mais les cinq autres seront sauvées.	如果医生拿了这个人的器官，这个人就死，但是五个重症病人就可以活下来。
Prélever les organes de cette personne en bonne santé est _______.	取健康人的器官是 _ _ _ _ _ _ 。
Si vous avez jugé le cas 1 acceptable, le 2 obligatoire et le 3 interdit, vous êtes comme les 1 500 sujets originaires du monde entier qui ont répondu à ces dilemmes dans le cadre de notre test de sens moral sur Internet (http://moral.wjh.harvard.edu/).	如果你判断第一种情况是1，也就是可以；第二种情况是2，也就是有义务；第三种情况是3，也就是禁止，那么，你就和全球1500名在我们的道德感网络测试（http : / /moral.wjh.harvard.edu / ） 回答了这些难题的人一样。
Or, si le sens moral est la parole de Dieu, les athées devraient juger ces cas différemment des gens religieux, et leurs réponses devraient reposer sur des justifications différentes.	如果道德是上帝之音，无神论者应当同信教的人对这些问题作出不同的判断，而且他们的回答应当依赖于不同的理由。
Par exemple, puisque les athées sont censés être dépourvus de boussole morale, ils ne devraient être dirigés que par leur propre intérêt et ne pas s'arrêter pour sauver l'enfant qui se noie.	例如，由于无神论者据称缺乏道德指南，他们应该完全受到纯粹的自私自利的引导而从那个就要淹死的女孩身边走过。
Mais il n'y a pas de différence statistique significative entre les sujets avec ou sans convictions religieuse, et environ 90% d'entre eux pensent qu'il est acceptable d'appuyer sur l'interrupteur du wagon, 97% qu'il est obligatoire de sauver le bébé et 97% qu'il est interdit de prélever les organes de l'homme en bonne santé.	但是，具有和不具有宗教背景的人之间并没有明显的统计上的差异，大约90％的人说把车厢换到岔道上是可以的，97％的人说救孩子是有义务的，而且97％的人说取健康人的器官是禁止的。
Lorsqu'on leur demande de justifier pourquoi certaines situations sont acceptables et les autres interdites, soit les sujets n'en savent rien, soit ils proposent des interprétations qui n'expliquent pas les différences de choix.	当被要求提供理由说有的情况是允许的而其他情况是禁止的，回答的人要么无言以对，要么无法解释相关的差异。
Ce qui est important, c'est que ceux qui ont une conception religieuse sont tout aussi désemparés ou incohérents que les athées.	重要的是，那些具有宗教背景的人也同无神论者一样无言以对或者前后不一。
Ces études fournissent un appui empirique à l'idée que, à l'image d'autres facultés psychologiques de l'esprit, notamment les langues et les mathématiques, nous sommes doués d'une faculté morale qui guide nos jugements instinctifs du bien et du mal.	如同头脑的其他能力，包括语言和数学一样，我们具有道德能力，可以指引我们对对错作出直觉判断。 这些研究为这一观点提供了经验主义的支持。
Ces intuitions reflètent l'aboutissement de millions d'années au cours desquelles nos ancêtres ont vécu comme des mammifères sociaux, et elles font partie de notre héritage commun.	这些直觉反应都是我们的祖先作为社会哺乳动物生存数以百万年的结果，也是我们共同的继承遗产的一部分。
Nos intuitions évoluées ne nous donnent pas nécessairement des réponses justes ou logiques à des dilemmes moraux.	我们演变的直觉并不告诉我们有关道德难题的正确或是一贯的解答。
Ce qui était bien pour nos ancêtres peut ne pas être bien aujourd'hui.	对于我们的祖先是好的东西在今天未必是好的。
Les prises de conscience des changements du contexte moral, dans lequel des sujets comme les droits des animaux, l'avortement, l'euthanasie et l'aide internationale se sont placés en première ligne, ne viennent pas de la religion mais d'une réflexion sérieuse sur l'humanité et sur ce que nous considérons être une vie bien vécue.	道德状况不断变化，例如，动物权利、堕胎、安乐死以及国际援助已经跃入道德讨论范围。 但是，对这些状况的洞察并非来自宗教，而是来自于对人性的认真思索以及我们所认为的良好的生活。
À cet égard, il est important que nous soyons conscients de l'universalité des intuitions morales pour pouvoir réfléchir dessus et, si tel est notre choix, pour agir à leur encontre.	在这一方面，知晓普世的道德直觉以便我们可以对它们进行思考是十分重要的。 而且，如果我们作出选择，也可以反其道而行之。
Nous pouvons le faire sans blasphème, car c'est notre propre nature, et non Dieu, qui est à la source de notre sens moral.	我们可以这样做而并不亵渎神灵，因为，我们的道德源泉是我们的本性，而非上帝。
	
L'émergence des combattants de Dieu !	上帝的勇士的数量正在培增
CHICAGO – Au Moyen-Orient, le temps ne joue pas en faveur de la paix.	芝加哥 - 时间对于中东的和平使者们并不有利。
Même les plus optimistes n'y croient plus.	即使是彻底的乐观主义者们也准备放弃了。
Des deux cotés, le conflit israélo-palestinien est de plus en plus sous la coupe et orchestré par des groupes religieux extrémistes qui sont peu disposés à faire la moindre concession et considèrent que leur mandat politique a un caractère sacré.	以色列和巴勒斯坦之间的冲突被双方的极端宗教势力弄得乌云笼罩并复杂喧嚣。 这些宗教团体不准备进行任何妥协，并视各自的政治权利为崇高神圣。
C'est un obstacle à toute résolution pacifique à court terme et plus le temps passe, plus il sera difficile de parvenir à un accord politique à long terme.	这样的形势，在短期内阻碍了的和平解决，在长期内使政治解决的可能性变得越来越小。
Plus que jamais, la paix est un mirage inaccessible.	和平比以往任何时候都犹如空中楼阁遥不可及。
Durant les 25 dernières années, différents acteurs en compétition dans la région ont embrassé la religion comme paradigme principal déterminant la politique intérieure.	在过去25年里，该地区各派互相竞争的利益集团都争相把宗教当作决定国内政策的主要考量标准。
Dans beaucoup de pays arabe, le renouveau fondamentaliste est à la fois significatif et déconcertant.	在许多阿拉伯国家，原教旨主义的复活，既影响重大，又令人不安。
Au Liban, le Hezbollah est maintenant une force avec laquelle il faut compter, alors que c'était l'un des pays les plus laïques du Moyen-Orient, l'Irak a été transformé en un Etat théocratique militant et en Palestine le Hamas monte en puissance au détriment de l'autorité du président Mahmoud Abbas.	真主党在黎巴嫩已经成了一支强大的力量；伊拉克从中东地区最无宗教色彩的国家之一变成了一个神权好战的国家；而哈马斯在巴勒斯坦风起云涌，削弱了马哈茂德·阿巴斯总统的威望。
La force politique du fondamentalisme religieux tient en grande partie à l'augmentation du nombre de fondamentalistes dans la population.	原教旨主义的大部分政治力量来源于原教旨主义者在人口中的比例增长。
Cette évolution démographique s'observe non seulement dans le monde musulman, mais aussi en Israël.	这种人口上的变化不仅发生在穆斯林世界中，也发生在以色列。
D'une démocratie de culture juive, Israël s'est lentement transformé en une démocratie dominée par la religion.	以色列正在慢慢地从一个犹太文化的民主国家变成一个被宗教所控制的国家。
Par exemple, la communauté ultra-orthodoxe des Haredi s'accroît à un rythme tellement rapide qu'elle redéfinit le paysage politique israélien.	哈瑞迪超正统宗教的教民人口正在高速增长，其速度之高，足以能重新定义国家的政治格局。
Selon les statistiques officielles, les femmes appartenant à cette communauté ont en moyenne 7,6 enfants, presque le triple de la moyenne nationale.	根据以色列的政府统计数字，每个哈瑞迪犹太妇女平均生育7.6个孩子，几乎是整个国家平均生育率率的三倍。
Parmi les 120 membres de la Knesset, 20 sont des ultra-orthodoxes (tous des hommes), contre cinq il y a 20 ans.	以色列议会的120个成员中，有20位（全部为男性）信奉，而几十年前仅有五位。
Le nombre de leurs partisans étant à la hausse, les ultra-orthdoxes devraient être de plus en plus nombreux à la Knesset.	以色列议会中的超正统宗教的人数预计将随着他们选民数的成倍增长而更趋增加。
Etant donné les divisions qui caractérisent le paysage politique israélien, cela pourrait permettre aux partis religieux d'exercer une pression significative sur le gouvernement.	在以色列典型的分割状的政治格局中，这种情况可以让有组织的宗教政党对政府施加巨大影响力。
Au même moment, beaucoup d'Israéliens éduqués et laïques choisissent d'émigrer, à la recherche d'une vie à l'abri de conflits incessants.	同时，许多受过教育和无宗教色彩的以色列人正选择移民他国，以追求没有永无休止的冲突的生活。
On estime à environ un demi-million (dont le quart est constitué d'universitaires réputés) le nombre d'Israéliens qui résident aux USA.	据统计，50万的以色列人目前居住在美国，这其中包括了以色列25%的顶尖学者。
Rien que dans la Silicon Valley, ils sont 40 000.	事实上，仅在硅谷，就居住了4万以色列人。
Cette émigration accélère indirectement l'évolution démographique d'Israël au profit de la droite religieuse.	这些移民也间接地加速了以色列人口结构的变化，这种变化而使宗教右翼获益。
On entend dire parfois que l'attirance pour l'ultra-orthodoxie exprime le rejet de la tradition libérale occidentale.	有些人认为皈依超正统教就是对西方自由主义传统的摒弃。
Le respect des règles religieuses exige d'importants sacrifices sur le plan social et financier.	遵守教义需要作出严肃而认真的社会和经济上的牺牲。
Beaucoup d'hommes suivent une formation religieuse dans des yechivas (écoles juives orthodoxes d'enseignement supérieur) jusqu'à l'âge de 40 ans et de ce fait n'acquièrent pas les connaissances nécessaires sur le marché du travail qui n'a rien de religieux.	许多男子在40岁前一直在YESHIVEAS（犹太正教教会高等学府）就读，这样就没法积累可以用于世俗生活市场的宝贵的人力资本。
L'augmentation de leur nombre pourrait finir par exercer une tension sur l'économie du pays.	当这些人的数量不断增加时，其对于以色列经济的负面影响也在不断增加。
Beaucoup des meilleurs cerveaux quittant le pays, Israël pourra-t-il rester intégré dans une économie de plus en plus mondialisée ?	事实上，在以色列众多的精英离开母国的情况下，以色列还能保持与日益全球化的经济融合吗？
Avec l'évolution démographique en cours, les responsables politiques israéliens doivent faire face à une situation problématique.	随着人口结构的不断变化，以色列的决策者们必须应付棘手的新的现实。
La forte natalité chez les ultra-orthodoxes israéliens a des conséquences sur les décisions politiques liées au processus de paix avec les Palestiniens.	以色列的超正统教教民的高出生率也正在对巴勒斯坦的和平进程的政治决策产生直接影响。
La plupart des 200 000 colons de Cisjordanie sont extrêmement religieux. Ils considèrent que leur présence à cet endroit répond à l'exigence d'une autorité supérieure à celle du gouvernement israélien.	在约旦河西岸的20万居民中的大多数都是极端宗教分子，他们认为他们居住在约旦河西岸是对权威的责任，这种权威比以色列政府所代表的权威更高。
Tant la droite religieuse israélienne que le Hamas à Gaza estiment que la croissance démographique joue en leur faveur, ceci malgré la rareté des différentes ressources.	以色列的宗教右翼和加沙的哈马斯都相信他们不断膨胀的人口是一种力量的源泉，尽管他们缺乏其它资源。
Aucun de ces deux groupes n'a la notion de la négociation et du compromis.	这两个组织所共同缺乏的是协商和让步的理念。
C'est pourquoi, aussi inquiétantes soit la perspective d'un Iran détenteur de l'arme nucléaire – pour le monde, pour Israël et pour les régimes arabes sunnites tels que l'Arabie saoudite et l'Egypte – une "bombe" iranienne serait sans doute plus facile à gérer que les bombes à retardement démographiques en Israël et chez ses voisins immédiats.	结果是，无论伊朗将来拥有核武器的前景 - 对世界、对以色列、对逊尼派阿拉伯地区的国家如沙特阿拉伯和埃及 - 可能会是多么地危险，伊朗的“炸弹”比起威胁以色列和它近邻的这颗人口结构的定时炸弹可能要更容易驾驭。
Il va bient��t être trop tard.	时间已经很紧迫了。
La démographie donne un nouveau visage à Israël et au Moyen-Orient.	人口问题正在改变着以色列和中东。
Des croyants exaltés se présentent comme les représentants locaux du Tout Puissant sur Terre.	狂热的宗教信仰者们正在宣称他们就是地球上“神”的代表。
Une nouvelle race de combattants de Dieu marginalise les dirigeants nationaux laïques.	新一代的神圣的勇士们正在把非带有宗教色彩的国家领袖们边缘化。
En général, les dirigeants d'inspiration divine ne conduisent pas l'humanité vers des chemins propices. Et ceux d'aujourd'hui ne sont en rien différents.	受神启示的统治者通常都不能引领人类走上繁荣美好的康庄大道，当今的他们也毫不例外。
	
Vie de chien	犬类杂谈
GAINESVILLE, FLORIDA – Il y a environ 70 millions de chiens domiciliés chez les humains aux Etats-Unis, et ils sont 10 millions de plus que les enfants de moins de 15 ans.	佛罗里达州盖恩斯维尔 — — 美国约有7000万条狗生活在人类家庭中，比15岁以下儿童还多1000万。
La proportion est identique à celle que l’on trouve dans les autres pays occidentaux.	其它欧洲国家的情况也大体相似。
40% de ces chiens familiers sont autorisés à dormir dans le lit de leur maître.	约有40%的狗狗可以睡在主人的床上。
Comment les chiens en sont-ils venus à prendre une place aussi intime dans nos vies?	犬类是如何在我们的生活中获得如此亲密的地位的？
Une théorie veut qu’au cours des milliers d’années qu’ils ont passées à côtoyer les hommes, les chiens se seraient mis au diapason de leurs façons de penser.	一种理论认为在与人类共同生活的几千年中，它们已经熟悉了人类的思维方式。
Il est vrai qu’ils sont extraordinairement réceptifs au comportement humain.	当然，犬类对于人类行为的敏感性的确令人惊叹。
Les chiens sont capables de trouver de la nourriture cachée, grâce aux gestes des hommes, et de leur indiquer par leurs mouvements où se cache un jouet.	犬类可以按照人类手势的指向找到隐藏的食物，它们还能成功地利用指向性动作来暗示主人玩具藏在何处。
Dans certaines circonstances, les chiens comprennent qu’une personne qui ne peut pas les voir (parce que, par exemple, elle a les yeux bandés) sera moins encline à répondre au quémandage d’une gourmandise, que quelqu’un dont les yeux ne sont pas couverts.	在某些情况下，犬类知道看不见它们的人（例如因为她的双眼被蒙住）与视力没有受到影响的人相比不太容易对它们想要美味食物的恳求做出反应。
Si leur maître reste sur place, les chiens sont également plus disposés à obéir à son ordre de ne pas prendre quelque chose qu’ils désirent, que s’il s’en va.	犬类在主人待在屋内的情况下更有可能服从不许动某些让它感兴趣的东西的命令。
Mais de là à mettre les facultés canines sur le même plan que l’intelligence humaine, il n’y a qu’un pas, qui glisse un peu rapidement sur une foule de façons de fonctionner des unes et de l’autre.	但将犬类的智慧和人类的智慧等同起来的观点掩盖了犬类和人类行为的许多细节。
Les processus de l’évolution ne déterminent jamais deux fois la même forme d’intelligence – même si les mêmes problèmes mènent aux mêmes solutions.	同样形式的智慧在进化中永远不会出现两次 — — 尽管相似的问题可能带来相似的解决方法。
Comme le savent généralement les gens qui ont adopté de jeunes chiens, il faut beaucoup de temps à un chien pour s’adapter au comportement de son maître.	多数小狗的主人都知道，我们需要付出时间和关爱才能让狗学会人类的行为方式。
Quand on est en colère, on n’a pas, littéralement, les poils qui se dressent, et quand on se fait de nouveaux amis, on ne se renifle pas nécessairement le derrière.	我们生气时不会竖起颈部的毛，在交新朋友的时候也不会去嗅对方的后背。
Les chiens, eux, ne gesticulent pas avec leurs pattes de devant, et ne recourent pas non plus à une grammaire élaborée, quand ils essaient d’expliquer les choses.	而犬类也不会用前爪打手势，或者使用复杂的语言语法试图解释问题。
Nos observations nous ont permis de voir qu’au cours des cinq premiers mois, les gens trouvent les chiens quelque peu impénétrables, et que, pour ce qui est de comprendre les êtres humains, les chiens de notre fourrière locale accusent de gros retards sur les chiens domestiques.	在研究中我们发现犬类在出生后的头五个月感觉人类在某种程度上非常神秘，而我们当地收容所里面的狗狗在理解人类方面大大落后于家养的犬类。
Alexandra Horowitz, du Barnard College de New York, s’est penchée, dans une étude récente, sur le “dialogue de sourds” qui survient parfois entre hommes et chiens.	纽约巴纳德学院Alexandra Horowitz最近的研究强调了人类和犬类之间有时会“自说自话 ” 。
Elle a demandé à des maîtres d’interdire à leur chien de prendre un biscuit, puis de quitter les lieux un court laps de temps.	Horowitz要求主人禁止他们的狗狗吃掉饼干，然后很快地离开房间。
A leur retour, une partie d’entre eux a appris que leur chien s’était mal conduit et avait mangé le biscuit défendu, et les autres, que leur chien avait été sage et n’avait pas touché au biscuit.	当主人几分钟后再次进屋时，有人被告知他们的狗狗非常淘气，吃掉了被禁止触碰的食物。 另外一些人被告知他们的狗狗表现良好，没有再去碰那块饼干。
A ceux dont le chien s’était montré désobéissant, il a été accordé un petit moment, afin qu’ils châtient l’animal pour son forfait.	如果狗狗表现不好，Horowitz给主人留出时间严厉批评它们刚才的错误。
Enfin, on a demandé aux maîtres si leur chien avait pris, ou non, un air coupable.	而后研究人员询问主人狗狗是否表现出愧疚的样子。
L’astuce, c’est que l’on n’a donné les bonnes informations qu’à la moitié des maîtres.	故事的曲折之处在于只有一半的主人被告知了正确的信息。
Tantôt Horowitz a dit au maître d’un chien qui n’avait pas touché le biscuit, qu’il n’y avait pas résisté, et tantôt elle a affirmé au maître d’un chien qui avait désobéi, qu’il avait été sage.	在半数情况下，Horowitz告诉实际没有去碰饼干的狗主人他的狗狗把饼干吃掉了。 还有半数情况下淘气狗狗的主人被告知他的狗狗表现良好。
En demandant à chacun des maîtres si son chien avait eu l’air coupable, ce subterfuge a permis à Horowitz de vérifier si la déposition du maître faisant état de “l’air de culpabilité” corroborait ou non les faits – à savoir que le chien avait pris le biscuit défendu – ou si sa déclaration ne trahissait rien d’autre que la correction infligée par le maître à son chien.	这个小小欺骗的目的在于当Horowitz询问每位狗主人他们的狗狗看上去是否愧疚时，她可以藉此了解主人报告的“愧疚之情”与事实真像 — — 狗狗是否吃掉了被禁止触碰的食物 — — 之间究竟有没有关系。 或者这种愧疚不过是主人严惩爱犬所造成的反应。
Les réponses ont très clairement montré que “l’air de culpabilité” du chien n’apparaissait que si l’animal avait été réprimandé: l’air n’avait rien à voir avec une quelconque faute du chien.	结果表明犬类之所以表现出“愧疚之情”完全是因为它遭到了训斥：那种表情与狗狗是否真的做了错事没有一点关系。
Cela ne signifie pas que nous n’ayons pas à corriger nos chiens (ou à les féliciter).	这并不是说我们不应该惩罚狗狗（或者表扬他们 ） 。
Ni qu’il nous soit interdit de les aimer – ou d’éprouver de temps en temps de l’exaspération à leur égard.	这也不是说我们不应该爱我们的狗狗 — — 或者某些时候对它们感到生气。
Tout ce que cela signifie, c’est que si nous voulons nous entendre avec une autre espèce, jusqu’au plus privé de notre vie, nous devons reconnaître que nos modes de raisonnement préférés ne sont pas les leurs.	这件事的全部含义是，如果我们想要在最亲密的环境中与另外一个物种和平共处，我们必须意识到有些时候它们并不理解我们所习惯的推理方式。
Nous devons essayer de comprendre les chiens selon leurs règles, et les aider à nous comprendre.	我们必须理解狗狗自己的想法，并帮助它们理解我们自己。
	
L'opposition djihadiste en Libye	利比亚的圣战少数派
DOHA - « Ils sont armés, je ne vais pas combattre en pure perte et faire tuer mes hommes pour un sanctuaire en ruines », a déclaré l'ancien ministre intérieur libyen Faouzi Abdelali, avant sa « démission » en août dernier.	发自多哈 — — 利比亚前内政部长法齐·阿卜杜拉·阿里(Fawzi Abd al - ‘ Aali)在其去年八月“辞职”前宣称 ： “ 对方全副武装，我不会为了一座倒塌的神殿打一场毫无胜算的仗，让自己的弟兄丧命 。 ”
Il faisait référence à des groupes armés salafistes accusés de détruire des sanctuaires soufis.	他所提到的“对方”是那些被控毁坏了伊斯兰苏菲派神殿的沙拉菲武装组织。
L'un des groupes accusé était la Brigade Ansar al-Sharia, qui a rapidement apporté son soutien à la démolition, mais a nié toute responsabilité.	其中一个组织是安萨尔·沙里亚旅（Ansar al-Shariah Brigade，阿拉伯语意为“教法支持者 ” ） — — 它在第一时间表示了对拆毁苏菲派神殿的支持，却拒绝对此事承担任何责任。
Ahmed Jibril, ambassadeur adjoint de la Libye à Londres, accuse à présent la Brigade dirigée par Mohammed Ali el-Zahawy, d'avoir perpétré l'attentat contre le Consulat américain à Benghazi, qui a tué l'ambassadeur américain Christopher Stevens et trois autres membres du personnel des États-Unis, ainsi que des gardes libyens.	利比亚驻英国副大使艾哈迈德·贾比尔（Ahmed Jibril）指控是穆罕默德·阿里·扎哈维（Muhammed Ali Al-Zahawy）率领的安萨尔·沙里亚旅袭击了班加西的美国领事馆 — — 这场袭击杀死了美国大使克里斯托夫·史蒂文斯 （Christopher Stevens ） 、 另外三名美国大使馆工作人员以及若干利比亚守卫。
D'autres personnes ont rapidement adopté et promu l'allégation de Jibril.	其他人则迅速接受了贾比尔的说法并加以宣扬。
Mais la situation est plus complexe.	但是实际情况比这复杂得多。
La Brigade a nié toute responsabilité dans une déclaration écrite, ainsi que dans un bref entretien avec son porte-parole, qui était alors chargé de la surveillance de l'hôpital d'Al Jala à Benghazi.	该组织在一份书面声明以及与其发言人 — — 该发言人当时负责班加西艾尔杰拉医院（Al JalaHospital）的保卫工作 — — 进行的采访中否认对这次袭击负责。
Comme lors de sa déclaration sur la destruction des sanctuaires soufis, la Brigade a nié toute implication dans l'attentat contre le Consulat américain, mais a souligné la gravité de l'insulte contre le Prophète censée avoir déclenché l'attentat.	一如它在苏菲派神殿事件上所做的声明那样，该组织否认参与对美国领事馆的袭击，并强调引发此次袭击的主要是侮辱先知的行为。
La Brigade a aussi attiré l'attention du public en juin dernier, quand près de 300 membres armés ont organisé un rassemblement à Benghazi, en suscitant l'indignation parmi les Libyens. « Nous avons voulu envoyer un message aux membres du Conseil National Général », a déclaré Hashim el-Nawa, l'un des commandants de la Brigade. « Ils ne doivent pas toucher à la charia.Elle doit être placée au-dessus de la Constitution et non pas devenir un article dans un référendum. »	这个组织在去年六月也引起过公众的注意 — — 300名全副武装的成员在班加西游行，煽动利比亚人民的愤怒情绪。 该组织指挥官之一哈希姆·那瓦（Hashim Al-Nawa）的说法是 ， “ 我们想要给全国委员会成员传达一条信息，他们不应该触碰伊斯兰教法。
	伊斯兰教法应该凌驾于宪法之上，不能作为（宪法）全民公决项目的其中一条 。 ”
Mais la Brigade Ansar al-Sharia était-elle vraiment derrière l'attentat contre le consulat américain ?	可安萨尔·沙里亚旅真的是袭击美国大使馆的幕后黑手吗？
La nature des forces armées postrévolutionnaires islamistes armées en Libye ne va vraiment pas de soi.	利比亚后革命时代的伊斯兰武装力量的本质决不是这么简单就可以理解的。
Le Jihad salafiste n'est pas une organisation, mais une tendance idéologique fondée sur la croyance selon laquelle les tactiques armées de toutes sortes sont les méthodes les plus efficaces - et, selon certaines versions, les plus légitimes - du changement social et politique.	沙拉菲圣战主义并不是一个组织机构，而是一个基于“各种形式的武装斗争策略都是最有效的 — — 在某些说法中也是最具合法性的 — — 社会和政治变革方式”这一核心信念的思潮。
L'année dernière, ses adhérents ont joué un rôle important dans la révocation du dictateur brutal de la Libye, le Colonel Mouammar Kadhafi.	去年其追随者在推倒残暴的独裁者穆阿迈尔·埃尔·卡扎菲（Muammar el-Qaddafi）上校一事上的确起了很重要的作用。
Beaucoup de ces tendances ont ensuite mûri politiquement, ont révisé leur vision du monde et sont passées d'un activisme armé à un activisme désarmé, en formant des partis politiques et en contestant les élections.	很多人之后都在政治上成熟起来并修正了自身的世界观，从武装转变为非武装行动，组建政党并参加选举。
Le Groupe Combattant Islamique Libyen a produit par exemple deux principaux partis politiques.	例如，利比亚伊斯兰战斗组织（LIFG）已经产生了两个主要的政党。
Al Watan (La Patrie) est dirigé par l'ancien GICL et commandant du Conseil militaire de Tripoli Abd el-Hakim Belhaj.	祖国党（Al Watan）由前利比亚伊斯兰战斗组织及黎波里军事委员会的指挥官阿卜杜·哈金姆·贝勒哈吉（Abd al-Hakim Belhaj）领导。
L'autre, Al Umma al-Wasat (The Nation centrale), est dirigé par Sami al-Saadi, ancien idéologue en chef du groupe, et Abd al-Wahad Qaid, un commandant militaire du GICL et frère du défunt commandant d'Al-Qaïda Qaid Hasan (Abou Yahya al-Libi).	另外一个中央国家党（Al Umma al-Wasat )由该组织前首席思想家萨米·萨阿迪（Sami al-Saadi）以及军事指挥官 — — 同时也是已故基地组织指挥官哈桑·卡伊德(化名Abu Yahya al-Libi)的哥哥��—阿卜杜·瓦哈德·卡伊德（Abd al-Wahad Qaid）共同领导。
Les deux partis ont fait piètre figure lors de l'élection d'un nouveau Congrès général national en juillet, où Qaid a remporté un seul siège.	两个政党在七月新国民议会的选举中都表现欠佳 — — 仅仅以瓦哈德赢得一席告终。
En effet, les élections du Congrès Général National ont été à bien des égards une défaite pour les partis non-violents salafistes de Libye (comme Al Asala), ainsi que pour les post-djihadistes.	的确，这次国民议会选举在很多方面对利比亚非暴力沙拉菲政党（比如阿沙拉）以及后圣战主义者来说都是一个打击。
D'autres formations islamistes armées, dont les groupes salafistes, ont accepté d'être intégrées aux nouvelles institutions de l'Etat libyen, comme le Comité Suprême de Sécurité (Ministère de l'Intérieur) et la Force du Bouclier libyen (Ministère de la Défense).	其他伊斯兰武装组织 — — 包括沙拉菲组织 — — 都愿意被整合进利比亚新的国家机构，比如最高安全委员会（内政部）以及利比亚防御力量（国防部 ） 。
La Garde nationale, dirigée par le chef adjoint du GICL, Khaled al-Sharif, a absorbé plus de 30 brigades, la plupart du temps en provenance de l'Ouest et du Sud-ouest.	由前LIFG副统帅卡勒德·沙里夫（Khaled al-Sharif）领导的国民警卫队则吸收了主要来自西部和西南地区的30多个武装组织。
Mais plusieurs formations armées, comme Ansar al-Sharia et les Brigades du Cheikh Omar Abd al-Rahman Emprisonné, rejettent encore la transition vers les partis politiques et vers l'intégration dans les institutions d'Etat.	然而有几个武装组织，比如安萨尔·沙里夫组织（Ansar al-Shariah）及现今仍在狱中的奥马尔·阿卜杜·拉赫曼（Omar Abd al-Rahman）的队伍仍然拒绝向党派政治过渡，也不愿意被整合到国家机构中。
Ces organisations sont nombreuses, mais petites.	这样的组织有很多，但规模都很小。
Certains n'ont pas été invitées à adhérer à des organismes officiels (ou bien on ne leur a pas donné une incitation suffisante).	有一些没有被邀请 — — 或者给予足够的激励 — — 去加入官方体系。
« Personne ne nous a demandé de rejoindre l'armée ou la police », explique Sufian ben Qumu, commandant d'Ansar al-Shariah à Derna et ancien détenu de Guantánamo, dans un entretien en avril dernier. « Ils ne m'ont même pas donné de récompense pour avoir combattu, ni à moi ni à aucun de mes hommes. » Ben Qumu entraîne une petite formation paramilitaire dans la forêt Bou Musafir dans la périphérie de Derna.	在去年四月的一个采访中，德尔纳地区的安萨尔·沙里夫组织指挥官，前关塔纳摩监狱囚犯苏菲安·本·库目（Sufian bin Qumu）说 ： “ 没有人叫我们加入军队或警队 ” ， “他们甚至没有给我或我的部下一点参加战斗的报酬 。 ” 本·库目在德尔纳郊区的布穆萨尔森林里有一个的准军事力量训练基地。
Il insiste sur le fait que si la direction des éclaireurs ou les chefs de clans de la ville lui demandaient de dissoudre le camp d'entraînement, il le ferait.	他坚持认为即使童子军的头或城市的宗族首领下令要求他遣散该训练营，他也一定会照办的。
La mort tragique de Stevens et de ses collègues a suscité une grande indignation du public en Libye, ajoutant à l'isolement et à la dé-légitimation des groupes armés.	史蒂文斯及其同僚的惨死已经在利比亚引起了众怒，也因此加快了对武装组织的孤立及去合法化。
Des dizaines de groupes de militants libyens ont mis en ligne des vidéos rendant hommage à Stevens, ainsi que des déclarations contre le terrorisme et contre Al-Qaïda.	许多利比亚激进主义组织上传了向史蒂文斯致敬的视频并发表了反对恐怖主义和基地组织的声明。
L'un des sites Internet des Frères musulmans contient une telle déclaration, et le Grand Moufti de Libye, le Cheikh Sadeq el-Gheriani, a également condamné l'attaque.	穆斯林兄弟会的其中一个网站里就有一个这样的声明，而利比亚的大穆夫提 — — 萨德克·盖里亚尼（Sadeq al-Gheriani）也谴责了这次袭击。
Deux questions restent essentielles en Libye pour prévenir de futures tragédies.	有两个问题对于防止这类悲剧在利比亚重演极为关键。
La première est la nécessité de capitaliser sur le soutien du public et de poursuivre le processus de désarmement, de démobilisation et de réinsertion qui a débuté sous le Conseil National de Transition, mais qui n'a jamais été mené à son terme.	一个是它需要利用公众支持继续裁军，遣散武装组织并且重新整编 — — 这个进程由全国过渡委员会发起但从未完成过。
Deuxièmement, le gouvernement doit améliorer sa stratégie de communication.	第二个是政府必须改善其沟通策略。
Les gouvernements du Printemps arabe ont condamné le film scandaleux insultant le Prophète de l'Islam, mais ils auraient dû souligner que les organismes américains officiels et officieux n'avaient rien à voir dans la production du film.	阿拉伯之春后诞生的政权都谴责抹黑伊斯兰先知穆罕默德的离谱电影，但他们本应该同时强调美国官方及非官方组织与这部电影的制作没有任何关系。
La punition collective et le ciblage des innocents est interdit dans plus de 20 versets du Coran : « Aucune personne chargée d'un fardeau (de péchés) ne doit porter le fardeau (des péchés) d'autrui » (L'Étoile, 53:38).	《古兰经》里有不止20行经文禁止集体惩罚以及攻击无辜者 ： “ 一个负罪的人，不负别人的罪 ” （ 53：38）
	
L’ombre de la Libye sur les fonds souverains	主权财富基金头上的利比亚阴影
NEW YORK - Alors que les citoyens de libyens reconstruisent leur vie et leur économie, le démantèlement de la corruption dans la Libyan Investment Authority (LIA), le fonds souverain dans lequel le régime de Mouammar el-Kadhafi aurait caché et abusé de la richesse pétrolière de la Libye, est devenu une priorité.	纽约 — — 随着利比亚人民重建他们的生活和经济，消除利比亚投资局（Libyan Investment Authority，LIA，由卡扎菲政权成立的主权财富基金，被认为用于隐匿和滥用利比亚的石油财富）的腐败成了优先项目。
Le Conseil National de Transition débat en ce moment sur l’instance qui doit prendre le relais de la Banque centrale de Libye et des actifs de la LIA - une décision particulièrement importante, étant donné que la production de pétrole ne devrait pas revenir à ses niveaux d'avant-guerre avant plusieurs années.	利比亚国家过渡委员会正在讨论由谁接手利比亚央行和LIA的资产。 这一决定非同小可，因为据估计，利比亚的石油产量在近几年内都不会回到战前水平。
Indépendamment de la façon dont le gouvernement libyen dirigera finalement la LIA, tous les fonds souverains - ainsi que leurs conseillers et leurs collecteurs de fonds - peuvent en tirer plusieurs leçons importantes.	不论利比亚政府最终决定如何处置LIA，世界所有主权财富基金（及其顾问和筹资人）都能从中吸取重要教益。
Bien sûr, on ne doit en aucun cas déduire du cas libyen que les autres fonds souverains riment en général avec la gangrène de la corruption et les conflits d'intérêt.	当然，我们不能从利比亚的例子中得出其他主权财富基金中也充满了腐败和利益冲突的结论。
La LIA a toujours été une exception : en effet, plusieurs indices de classement des fonds souverains sur la transparence, la responsabilisation et les questions de gouvernance n’ont traditionnellement classé que l'Iran à un rang inférieur à la Libye.	LIA永远是个特例；事实上，不少追踪各主权财富基金透明度、责任和治理的指数表明，比LIA还不如的只有伊朗了。
Pourtant, alors que les dossiers difficiles ont tendance à faire de mauvaises lois et qu’il est trop tôt pour juger, la LIA doit servir de signal d’alarme pour les sociétés et les fonds à la fois au Moyen-Orient et dans le monde entier.	但是，尽管疑难案例总是倾向于开启恶例，且现在下结论还为时过早，但LIA对中东和全世界的公司和基金来说仍不啻为一次警示。
Premièrement, les gouvernements devraient mieux préciser les sources de financement derrière chaque investissement particulier.	首先，政府应该更好地检查每个特定投资项目背后的资金来源。
Le financement privé qui s'avère être le financement public lié à la famille régnante, ou lié aux ministres du gouvernement, présente différents risques politiques et financiers et doivent donc être évalués différemment.	套着公共资金外衣、实际上来自统治家族或政府高官的私人资金具有不同的政治和财务风险，因此应该用不同的方法评估。
Deuxièmement, la crise libyenne a cristallisé le problème des actions d’entreprises appartenant à des gouvernements souverains.	其次，利比亚的危机表明，主权政府持有公司股份会造成很大问题。
Quand les États-Unis et l'Union européenne ont décidé d'imposer des sanctions au régime libyen, telles que le gel des actions détenues par la LIA dans les entreprises européennes et américaines, de nombreux dirigeants de ces sociétés ont été surpris par la façon radicale dont leurs entreprises ont été affectées par le régime de propriété.	当美国和欧盟决定对利比亚政权予以制裁的时候 — — 包括冻结LIA所持有的欧洲和美国公司股份 — — 许多涉案公司高管对所在公司所有权结构受到的影响大惊失色。
De toute évidence, la liquidité des actions et la perception d'un manque d’attention de la part des dirigeants d'entreprise soulève des questions de première importance.	显然，这些股份的流动性以及人们对公司管理层不胜任的觉察绝不是小事。
Troisièmement, la saga LIA souligne la probabilité d’un effet cumulatif des fonds souverains sur la stabilité des marchés mondiaux.	第三，LIA案例凸显了主权财富基金对全球市场稳定性的潜在积累效应。
Tous les fonds souverains peuvent répondre aux événements politiques mondiaux en retirant rapidement les fonds investis à l'étranger.	对于全球政治事件，所有主权财富基金的反应可能完全一样：迅速撤回海外投资资金。
Comme l'a révélé l’un des documents Wikileaks, les diplomates américains ont forcé le gouvernement libyen, pendant la crise financière, à conserver des fonds dans les banques américaines, et à investir directement dans une institution américaine en difficulté financière.	维基解密所披露的一份文件表明，金融危机期间，美国外交官游说利比亚政府不要抽离投资于美资银行的资金，还鼓动后者直接投资一家受困的美国金融机构。
Dans ce cas, les Libyens n'ont pas répondu en retirant une grande quantité de fonds, mais ceci pourrait arriver dans l'avenir.	在这个案例中，利比亚并没有大量抽回资金，但并不意味着未来不会出现主权财富基金大量撤资的情形。
Certains soutiennent que les gouvernements d'accueil et les pays hôtes des fonds souverains ont trop d'intérêts en commun - y compris la stabilité du système financier et le maintien du dollar américain comme monnaie de réserve mondiale - pour menacer les marchés mondiaux.	有人指出，主权财富基金的母国政府和东道国有着太多的共同利益 — — 包括金融体系的稳定性和维持美元的世界储备货币地位 — — 因此它们不会反应过度从而威胁到全球市场。
Cela est vrai en moyenne et en temps normal, mais qu'adviendrait-il si plusieurs fonds souverains, en réponse à l'incertitude et la volatilité soudaine, se retiraient en même temps pour des raisons diplomatiques ou commerciales?	这不无道理，在常态时大体上正是如此，但如果各国主权财富基金为了应对突发不确定性和市场波动，从而出于外交和商业原因同时撤资，事情又会如何？
Un comportement individuel rationnel est souvent collectivement suicidaire.	个体的理性行为经常会造成集体的自我毁灭。
Enfin, le cas libyen et la crise de la dette de Dubaï de 2009 pourraient accroître le soupçon dans le monde développé et le mener au protectionnisme envers les fonds souverains, en particulier ceux d'Afrique du Nord et du Golfe.	最后，利比亚案例和2009年的迪拜债务危机可能会增加发达国家的疑虑，导致针对主权财富基金（特别是来自北非和海湾地区者）的保护主义。
La libre circulation des capitaux des fonds souverains de ces régions, vers des sociétés dans les pays avancés, est cruciale pour équilibrer l'économie mondiale et pour fournir des liquidités aux marchés financiers, en particulier dans la perspective d'une nouvelle récession en Occident.	资本从这些地区向发达国家公司的自由流动是平衡全球经济、为金融市场提供流动性的关键，特别是在西方面临着另一场衰退的当口。
Les pays d’accueil tout autant que les pays hôtes devront s'assurer que le conflit actuel de la LIA n’entravera pas cet important processus.	母国和东道国都必须确保当前在LIA身上的冲突不会阻碍这一重要过程。
Mais sommes-nous justes quand nous comparons les fonds souverains des diverses régions en nous attendant à ce qu'ils adhèrent aux normes occidentales?	但我们这样比较不同地区的主权财富基金并要求它们遵循西方标准公平吗？
Les efforts en cours pour restructurer la Banque Centrale de Libye et la LIA vont affecter les perceptions des marchés d'autres acteurs souverains de la région.	当前重组利比亚央行和LIA的举措将影响市场对该地区其他主权财富基金的感觉。
On peut penser à Bahreïn et Dubaï.	巴林和迪拜将受到怀疑。
Bien que les récents rapports du Groupe de travail international sur les fonds souverains aient indiqué les difficultés d'application des normes de gouvernance uniforme, plusieurs mesures sont nécessaires afin d’aider le retour de la Libye sur les marchés financiers mondiaux.	尽管主权财富基金国际工作组的最新报告表明，使用统一治理标准尚有诸多困难有待克服，但我们仍然需要一些措施，把利比亚重新纳入全球资本市场。
Malgré le statut unique de l'économie de la Libye et le système politique d'aujourd'hui, scruter le processus d'investissement des sociétés étrangères, ainsi que la définition de la nature des relations entre le régime libyen et la gestion de fonds, sont nécessaires pour assurer de saines relations commerciales entre les souverains et leurs portefeuilles d'investissements.	如今，利比亚经济和政治体系有着独一无二的地位，但详细审查投资外国公司的过程、厘清利比亚政权与基金管理之间关系的性质对于确保各主权财富基金与其投资组合之间保持健康商业关系来说是必不可少的。
D'importantes distributions fondées sur des préoccupations politiques pragmatiques, comme les relations entre la Libye et l'Italie ou le copinage, devraient être réévaluées selon des pratiques de gouvernance meilleures et plus solides.	基于实用主义政治考虑（比如利比亚-意大利关系）或裙带主义的大资金分配应该被重新评估，并要以更好更强的治理实践作为标准。
Les gouvernements et les entreprises devraient assimiler le message et tirer les leçons de l'exemple libyen.	政府和公司都应该认真消化利比亚案例并从中汲取教益。
Le choix s’avèrera peut être trop coûteux pour les actionnaires tout comme pour les citoyens.	若非如此，股东和公民将付出沉重代价。
	
Les révolutionnaires réticents de Lybie	利比亚之被迫进行革命者
TRIPOLI – L'Egypte n'est pas le seul endroit où les grandes espérances du Printemps arabe s’évanouissent peu à peu.	的黎波里 — — “阿拉伯之春”光明的希望正逐渐消退，其地区不仅仅是在埃及。
Attaques contre les gouvernements occidentaux, affrontements ethniques dans de lointaines oasis au milieu du désert… la révolution de la Libye est elle aussi chancelante.	从对西方政府的抗争到遥远的沙漠绿洲里的种族冲突，利比亚革命的势头正在逐渐衰弱。
Le gouvernement intérimaire, qui a dirigé le soulèvement, est en grande partie responsable pour troubles actuels de la Libye.	目前利比亚困境重重，这在很大程度上归咎于临时政府领导的起义。
Le Conseil National de Transition refuse de prendre des décisions difficiles, préférant les refiler à un futur gouvernement élu.	全国过渡委员会（NTC）很难作出抉择，只是假装要成立一个民选政府。
Le CNT a conservé une grande partie de la paralysie institutionnelle du pays, ainsi que du comportement primaire typique du régime renversé du colonel Muammar al-Kadhafi.	被推翻的穆阿迈尔·卡扎菲上校所领导的政府的典型特征是机构内部瘫痪以及依赖下意识行事，而NTC依然保留了很多诸如此类的问题。
Si la révolution libyenne veut réussir, les nouveaux dirigeants du pays devront rompre nettement avec l'esprit du passé.	利比亚革命若想取得成功，新一代国家领导人就必须要彻底打破过去的思想。
Au cours de ses 42 années au pouvoir, Kadhafi s’est entouré de conseillers qui étaient des compagnons de jeunesse, complétés par une petite clique de technocrates.	在执政的42年间，卡扎菲身边的顾问一直是自己年轻时的玩伴，然后就是一些技术专家。
En conséquence, les chefs de la révolte qui l’a renversé ont peu d'expérience de gouvernement.	结果，推翻其政府的领导人所具备的政府经验微乎其微。
Et, dans un pays où toute activité politique était considérée comme une trahison, beaucoup s'attendaient à ce que le CNT néophyte tombe souvent et peu après son entrée en fonction.	此外，在一个将任何政治活动均视为叛逆行为的国家，很多人预测刚成立的NTC从开始就会遭受重重困难。
Ils ne se sont pas trompés.	而事实上也的确如此。
En effet, la révolution n'a jamais été sans heurts.	事实上，革命从来都不是一帆风顺的。
Lorsque les combattants ne sont pas parvenus à vaincre les forces loyalistes par eux-mêmes, les puissances extérieures ont été obligées d'intervenir.	当革命人士未能击败政府军时，外部力量就会被迫介入。
Plus tard, le CNT s’est retrouvé incapable d'imposer une discipline aux myriades de milices qui se sont formées pour combattre les troupes de Kadhafi, ni même de diriger efficacement les armes étrangères vers l'armée nationale libyenne naissante.	大量民兵都参与进来同卡扎菲军队进行作战。 之后，NTC无法向这些民兵施加纪律，甚至无法将外国武器有效地运用于刚刚成立的利比亚国家军队。
Lorsque le chef d'état-major a été assassiné en juillet dans des circonstances mystérieuses, le CNT n’a pas pu offrir de réponses concrètes à un public en colère.	7月份，军事参谋长被秘密暗杀，而NTC却无法给愤怒的公众提供任何确凿的解释。
N'ayant pas accès aux avoirs libyens gelés à l'étranger, il a souvent payé les salaires avec des semaines de retard.	因无法动用利比亚的任何国外冻结资产，它经常将工资拖欠几周之久。
Tant que la lutte contre Kadhafi faisait rage, les Libyens considéraient comme antipatriotique de souligner les faiblesses du CNT.	虽然对抗卡扎菲的斗争依然十分激烈，但是利比亚人认为，指出NTC的弱点是不爱国的行为。
Aujourd'hui, cependant, ces défauts ont été amplifiés par sa paralysie.	然而，在今天，政府机构的瘫痪状态放大了这些缺陷。
Le CNT délibère au lieu de décider.	这是NTC反复审议的结果，并非一项简单的决策。
La majorité des deux-tiers requise pour adopter une loi signifie que les projets de loi meurent après de longs débats.	按照规定，立法需要有三分之二的人数通过，这意味着很多法案在经过广泛的辩论后最终会消亡。
De nombreux membres du CNT pensent que le Conseil n'a pas la légitimité nécessaire pour prendre des décisions difficiles.	NTC的很多委员都认为，安理会缺乏合理性，因而对于一些比较艰难的决定它无法做出抉择。
Ils soutiennent que le CNT devrait se limiter à assurer un gouvernement intérimaire, ne mettant en œuvre que les décisions les plus essentielles, jusqu’à ce que des responsables élus entrent en fonction.	他们认为，NTC只是一个代理政府，仅负责实施那些最重要的决议，直至民选官员上任。
En conséquence, le CNT et le cabinet qu'il a nommé, appelé comité exécutif, cherchent simplement passer le relais de l'autorité.	因此，NTC和其任命的内阁（即执行委员会 ） ， 只是想尽快移交权利。
Hésitant à laisser une empreinte importante dans leur sillage, certains ministères ne disposent d’aucun budget et les ministres sont réticents à signer des accords avec des entreprises étrangères.	一些部门不愿留下大量的遗留问题，因此他们没有预算，而且各部长也不愿同外国公司签署协议。
Mais, au-delà de la question du rôle approprié des gouvernements dépositaires, il y a l'indécision des dirigeants du CNT, qui préfèrent tout simplement s'en remettre à d'autres.	然而，除了代理政府应当充当怎样的角色这个问题以外，另一个问题是NTC领导人的优柔寡断，他们总是倾向于听从他人。
Quand un colonel a récemment demandé au président du CNT Mustafa Abdel-Jalil pourquoi il n'a pas cherché à fusionner les milices dans l'armée nationale, Abdel-Jalil a répondu, "je ne dirige que la branche législative.	最近一名上校问NTC主席穆斯塔法·阿卜杜勒-加里尔为什么不将广大民兵合并成一支国家军队，阿卜杜勒-加里尔答道 ： “ 我可以负责立法部门。
Vous devez parler à l'exécutif (le comité). "	而你必须要同执行（委员会）进行商讨 。 ”
D'autres hauts responsables libyens souffrent de la même incapacité de gestion.	利比亚的其他高级官员也面临同样的管理问题。
Le premier ministre du CNT, Mahmoud Jibril, a été salué par la communauté internationale pour sa vision.	NTC的第一任总理马哈茂德·贾布里勒因其远见卓识而受到国际社会的高度赞扬。
Mais, tout comme Abdel-Jalil, Jibril s'est montré incapable de prendre des décisions.	但是，他同阿卜杜勒-加里尔十分相似，事实证明，他也没有决策能力。
La paralysie du CNT est clairement reflétée dans le procès du fils de Kadhafi, Saif al-Islam el-Kadhafi.	NTC的无能在对卡扎菲的儿子赛义夫·伊斯兰·卡扎菲的审判上反映地尤其明显。
Bien que considéré comme le captif le plus précieux de l'Ancien Régime, le Conseil n’a fait que peu de progrès dans les poursuites judiciaires.	虽然安理会被视为“旧制度”最忠诚的守护者，但是在对他的起诉方面理事会的进展甚微。
Ahmad Jihani, représentante de la Libye à la Cour Pénale Internationale, me disait récemment que, « nous, Libyens, ne pouvons pas commencer le procès de Saif.	国际刑事法院利（IVCC）比亚代表艾哈迈德最近告诉我说 ： “ 我们利比亚人不能开始对赛义夫的审判。 利比亚没有可以起诉他的中央权力 。 ”
Il n'y a pas de pouvoir central pour le poursuivre. » Le procureur de la CPI faisait écho à ce sentiment dans une brève juridique du 5 juin, en notant que « le gouvernement de la Libye peut être incapable de faire avancer l'affaire. » En l'absence de progrès vers un jugement de Kadhafi pour crimes de guerre, la CNT le détient sous le chef d’accusation inoffensif de ne pas posséder une licence de chameau.	6月5日的法律简报中，国际刑事法院检察官也呼应了他的这一观点，他指出 ： “ 也许，在这一案件上利比亚政府不会取得多大进展 。 ” 若在对卡扎菲的战争罪行所作的审判不能取得进展，NTC的指控将不会对他产生任何威胁，这也说明NTC无力处理刑事案件。
	政府官员对部长们的优柔寡断十分感慨。
Les bureaucrates déplorent les tergiversations ministérielles. « Les gens ordinaires viennent avec des idées de démobiliser les combattants et de les intégrer dans la société », fait remarquer un fonctionnaire du ministère du travail, en se référant au problème le plus urgent auquel est confronté la CNT. « Mais, sans personne pour prendre une décision, tous ces plans s’empilent sur nos bureaux en vain. »	“每天人们都想着要战士们复员，令其融入社会 。 ” 劳动部的一位官员指出这是NTC所面临的最迫切的问题 ， “ 但是，若没有人作出决议的话，所有一切的计划就只能被搁浅 。 ”
Une des raisons de cette inertie est à trouver dans la culture politique dominante en Libye.	政府无能的原因之一可以在利比亚的主流政治文化中找到根源。
Pendant des décennies, Kadhafi a personnellement revu chaque accord dont la valeur dépassait les 200 millions de dollars et choisissait souvent quelles entreprises étrangères obtenaient les contrats.	几十年来，对于每项价值超过2亿美元的协议，卡扎菲都���自审阅，而且他往往会选择那些外国公司会接收合同的协议。
Quand il a dévolu la planification ministérielle aux bureaucrates en 2008, il y eu beaucoup de mécontents. « Sans habitude de planification et possédant des capacités humaines limitées, les hauts fonctionnaires dans les ministères sont très nerveux», signalait un câble diplomatique américain publié par Wikileaks.	2008年，他将部长级规划移交给政府官员后，很多人都十分不开心。 维基解密所发布美国外交电报报道 ： “ 由于不习惯做规划，而且个人能力又十分有限，因而各部委的高级官员都十分焦虑 。 ”
Les nouveaux dirigeants de la Libye ne font pas que de traîner les pieds.	利比亚的新领导人所面临的困境比拖拉懒散还要糟糕。
Ils se rabattent sur les mêmes réponses faciles et préfabriquées que Kadhafi a utilisé pendant quatre décennies pour diaboliser ses adversaires nationaux et internationaux.	40年来，卡扎菲一直都是草率、临时地丑化各种国内和国际对手。 而现在，新的领导人又是在重蹈覆辙。
Par exemple, lorsque les Libyens de l'est ont récemment annoncé la formation d'un conseil régional provisoire en tant que première étape vers la proclamation de l'état fédéraliste, Abdel-Jalil a vu « le début d'un complot contre la Libye » dans le climat de crise entre les provinces du pays. « Certains pays arabes, malheureusement, ont soutenu et encouragé cet événement », a-t-il déclaré.	例如，利比亚东部的民众最近宣布成立了一个临时区域市政局，作为成立一个联邦国家的第一步。 阿卜杜勒-加里尔声称在全国各省间滋生的危机中“衍生了一个反对利比亚的阴谋 。 ”
	他说 ： “ 不幸的是，有些利比亚国家支持并鼓励这种情况的发生 。 ”
Mais Abdel-Jalil n’a nommé aucun des pouvoirs étrangers en particulier et n’a offert aucune preuve pour étayer ses allégations, qui rappelaient un peu les diatribes fréquentes que Kadhafi lançait contre « les complots de l'impérialisme sioniste. »	但是，阿卜杜勒-加里尔没有指明具体的外国势力，也未提供任何证据来支持其指控。 这听起来特别像是卡扎菲频繁地高声痛斥“帝国主义-犹太复国主义者阴谋 。 ”
Après une révolution de huit mois qui a dévasté le pays, les Libyens ont le droit d’exiger des réformes réelles.	历时8个月之久的革命摧毁了整个国家。 革命之后，利比亚人要求进行真正的变革。
Mais, sans une nouvelle direction qui est prête à les mettre en œuvre, il faudra encore beaucoup de temps avant que la Libye ne tourne une nouvelle page.	然而，如果没有一个愿意实行改革的领导集团，利比亚若想翻开新的一页尚需经历一段很长的时间。
	

